SKILLNAME	ICON	ACTIVITY_TYPE
s	s	s
class_forcesensitive_phase1_novice	/Styles.Icon.command.fs_dm	
class_forcesensitive_phase1_02	/Styles.Icon.command.fs_buff_ca	
class_forcesensitive_phase1_03	/Styles.Icon.command.fs_buff_def_1	
class_forcesensitive_phase1_04	/Styles.Icon.command.fs_sweep	
class_forcesensitive_phase1_05	/Styles.Icon.command.fs_buff_ca	
class_forcesensitive_phase1_master	/Styles.Icon.command.fs_dm	
class_forcesensitive_phase2_novice	/Styles.Icon.command.fs_buff_def_1	
class_forcesensitive_phase2_02	/Styles.Icon.command.saberBlock	
class_forcesensitive_phase2_03	/Styles.Icon.command.fs_buff_ca	
class_forcesensitive_phase2_04	/Styles.Icon.command.fs_sh	
class_forcesensitive_phase2_05	/Styles.Icon.command.fs_sweep	
class_forcesensitive_phase2_master	/Styles.Icon.command.fs_dm	
class_forcesensitive_phase3_novice	/Styles.Icon.command.fs_sweep	
class_forcesensitive_phase3_02	/Styles.Icon.command.fs_dm_cc_crit	
class_forcesensitive_phase3_03	/Styles.Icon.command.fs_buff_def_1	
class_forcesensitive_phase3_04	/Styles.Icon.command.fs_sh	
class_forcesensitive_phase3_05	/Styles.Icon.command.fs_buff_ca	
class_forcesensitive_phase3_master	/Styles.Icon.command.fs_dm	
class_forcesensitive_phase4_novice	/Styles.Icon.command.fs_buff_def_1	
class_forcesensitive_phase4_02	/Styles.Icon.command.fs_dm	
class_forcesensitive_phase4_03	/Styles.Icon.command.fs_sweep	
class_forcesensitive_phase4_04	/Styles.Icon.command.fs_sh	
class_forcesensitive_phase4_05	/Styles.Icon.command.fs_buff_def_1	
class_forcesensitive_phase4_master	/Styles.Icon.command.fs_dm	
class_bountyhunter_phase1_novice	/Styles.Icon.command.bh_dm	
class_bountyhunter_phase1_02	/Styles.Icon.command.bh_dm_crit	
class_bountyhunter_phase1_03	/Styles.Icon.command.bh_dm_cc	
class_bountyhunter_phase1_04	/Styles.Icon.command.bh_dm	
class_bountyhunter_phase1_05	/Styles.Icon.command.bh_dm_crit	
class_bountyhunter_phase1_master	/Styles.Icon.command.bh_dm_cc	
class_bountyhunter_phase2_novice	/Styles.Icon.command.bh_dm	
class_bountyhunter_phase2_02	/Styles.Icon.command.bh_dm_cc	
class_bountyhunter_phase2_03	/Styles.Icon.command.bh_dm	
class_bountyhunter_phase2_04	/Styles.Icon.command.bh_sh	
class_bountyhunter_phase2_05	/Styles.Icon.command.bh_del_cc	
class_bountyhunter_phase2_master	/Styles.Icon.command.bh_dm	
class_bountyhunter_phase3_novice	/Styles.Icon.command.bh_ae_dm	
class_bountyhunter_phase3_02	/Styles.Icon.command.bh_del_dm_cc_dot	
class_bountyhunter_phase3_03	/Styles.Icon.command.bh_dm	
class_bountyhunter_phase3_04	/Styles.Icon.command.bh_sh	
class_bountyhunter_phase3_05	/Styles.Icon.command.bh_del_cc	
class_bountyhunter_phase3_master	/Styles.Icon.command.bh_dm	
class_bountyhunter_phase4_novice	/Styles.Icon.command.bh_del_dm_cc_dot	
class_bountyhunter_phase4_02	/Styles.Icon.command.bh_ae_dm	
class_bountyhunter_phase4_03	/Styles.Icon.command.bh_dm	
class_bountyhunter_phase4_04	/Styles.Icon.command.bh_sh	
class_bountyhunter_phase4_05	/Styles.Icon.command.bh_del_cc	
class_bountyhunter_phase4_master	/Styles.Icon.command.bh_del_dm_cc_dot	
class_smuggler_phase1_novice	/Styles.Icon.command.sm_dm	
class_smuggler_phase1_02	/Styles.Icon.command.sm_dm_cc	
class_smuggler_phase1_03	/Styles.Icon.command.sm_ae_dm_cc	
class_smuggler_phase1_04	/Styles.Icon.command.sm_dm	
class_smuggler_phase1_05	/Styles.Icon.command.sm_dm_cc	
class_smuggler_phase1_master	/Styles.Icon.command.sm_ae_dm_cc	
class_smuggler_phase2_novice	/Styles.Icon.command.sm_dm	
class_smuggler_phase2_02	/Styles.Icon.command.sm_dm_cc	
class_smuggler_phase2_03	/Styles.Icon.command.sm_ae_dm_cc	
class_smuggler_phase2_04	/Styles.Icon.command.sm_sh	
class_smuggler_phase2_05	/Styles.Icon.command.sm_del_dm_cc	
class_smuggler_phase2_master	/Styles.Icon.command.sm_dm	
class_smuggler_phase3_novice	/Styles.Icon.command.sm_dm_dot	
class_smuggler_phase3_02	/Styles.Icon.command.sm_ae_dm	
class_smuggler_phase3_03	/Styles.Icon.command.sm_dm	
class_smuggler_phase3_04	/Styles.Icon.command.sm_sh	
class_smuggler_phase3_05	/Styles.Icon.command.sm_del_dm_cc	
class_smuggler_phase3_master	/Styles.Icon.command.sm_dm	
class_smuggler_phase4_novice	/Styles.Icon.command.sm_dm_dot	
class_smuggler_phase4_02	/Styles.Icon.command.sm_ae_dm	
class_smuggler_phase4_03	/Styles.Icon.command.sm_dm	
class_smuggler_phase4_04	/Styles.Icon.command.sm_sh	
class_smuggler_phase4_05	/Styles.Icon.command.sm_del_dm_cc	
class_smuggler_phase4_master	/Styles.Icon.command.sm_ae_dm	
class_commando_phase1_novice	/Styles.Icon.command.co_dm	
class_commando_phase1_02	/Styles.Icon.command.co_del_ae_cc_1	
class_commando_phase1_03	/Styles.Icon.command.co_ae_dm	
class_commando_phase1_04	/Styles.Icon.command.co_dm	
class_commando_phase1_05	/Styles.Icon.command.co_del_ae_cc_1	
class_commando_phase1_master	/Styles.Icon.command.co_ae_dm	
class_commando_phase2_novice	/Styles.Icon.command.co_dm	
class_commando_phase2_02	/Styles.Icon.command.co_del_ae_cc_1	
class_commando_phase2_03	/Styles.Icon.command.co_ae_dm	
class_commando_phase2_04	/Styles.Icon.command.co_sh	
class_commando_phase2_05	/Styles.Icon.command.co_del_ae_dm	
class_commando_phase2_master	/Styles.Icon.command.co_dm	
class_commando_phase3_novice	/Styles.Icon.command.co_fld_dm	
class_commando_phase3_02	/Styles.Icon.command.co_del_ae_cc_2	
class_commando_phase3_03	/Styles.Icon.command.co_dm	
class_commando_phase3_04	/Styles.Icon.command.co_sh	
class_commando_phase3_05	/Styles.Icon.command.co_del_ae_dm	
class_commando_phase3_master	/Styles.Icon.command.co_dm	
class_commando_phase4_novice	/Styles.Icon.command.co_fld_dm	
class_commando_phase4_02	/Styles.Icon.command.co_del_ae_cc_2	
class_commando_phase4_03	/Styles.Icon.command.co_dm	
class_commando_phase4_04	/Styles.Icon.command.co_sh	
class_commando_phase4_05	/Styles.Icon.command.co_del_ae_dm	
class_commando_phase4_master	/Styles.Icon.command.co_dm	
class_officer_phase1_novice	/Styles.Icon.command.of_dm	
class_officer_phase1_02	/Styles.Icon.command.of_deb_def	
class_officer_phase1_03	/Styles.Icon.command.of_buff_def	
class_officer_phase1_04	/Styles.Icon.command.of_dm	
class_officer_phase1_05	/Styles.Icon.command.of_deb_def	
class_officer_phase1_master	/Styles.Icon.command.of_buff_def	
class_officer_phase2_novice	/Styles.Icon.command.of_dm	
class_officer_phase2_02	/Styles.Icon.command.of_buff_def	
class_officer_phase2_03	/Styles.Icon.command.of_deb_def	
class_officer_phase2_04	/Styles.Icon.command.of_sh	
class_officer_phase2_05	/Styles.Icon.command.of_del_ae_dm_dot	
class_officer_phase2_master	/Styles.Icon.command.of_dm	
class_officer_phase3_novice	/Styles.Icon.command.of_del_ae_dm	
class_officer_phase3_02	/Styles.Icon.command.of_del_ae_dot	
class_officer_phase3_03	/Styles.Icon.command.of_dm	
class_officer_phase3_04	/Styles.Icon.command.of_sh	
class_officer_phase3_05	/Styles.Icon.command.of_del_ae_dm_dot	
class_officer_phase3_master	/Styles.Icon.command.of_dm	
class_officer_phase4_novice	/Styles.Icon.command.of_del_ae_dm	
class_officer_phase4_02	/Styles.Icon.command.of_del_ae_dm_dot	
class_officer_phase4_03	/Styles.Icon.command.of_dm	
class_officer_phase4_04	/Styles.Icon.command.of_sh	
class_officer_phase4_05	/Styles.Icon.command.of_del_ae_dm	
class_officer_phase4_master	/Styles.Icon.command.of_dm	
class_spy_phase1_novice	/Styles.Icon.command.sp_dm	
class_spy_phase1_02	/Styles.Icon.command.sp_buff_stealth	
class_spy_phase1_03	/Styles.Icon.command.sp_buff_invis	
class_spy_phase1_04	/Styles.Icon.command.sp_dm	
class_spy_phase1_05	/Styles.Icon.command.incognito	
class_spy_phase1_master	/Styles.Icon.command.me_rv_combat	
class_spy_phase2_novice	/Styles.Icon.command.sp_dm	
class_spy_phase2_02	/Styles.Icon.command.sp_buff_invis	
class_spy_phase2_03	/Styles.Icon.command.sp_decoy	
class_spy_phase2_04	/Styles.Icon.command.sp_sh	
class_spy_phase2_05	/Styles.Icon.command.sp_fldmot	
class_spy_phase2_master	/Styles.Icon.command.sp_dm	
class_spy_phase3_novice	/Styles.Icon.command.sp_dot	
class_spy_phase3_02	/Styles.Icon.command.sp_fldmot	
class_spy_phase3_03	/Styles.Icon.command.sp_dm	
class_spy_phase3_04	/Styles.Icon.command.sp_sh	
class_spy_phase3_05	/Styles.Icon.command.sp_fld_debuff_ca	
class_spy_phase3_master	/Styles.Icon.command.sp_dm	
class_spy_phase4_novice	/Styles.Icon.command.sp_cc_dot	
class_spy_phase4_02	/Styles.Icon.command.sp_fldmot	
class_spy_phase4_03	/Styles.Icon.command.sp_dm	
class_spy_phase4_04	/Styles.Icon.command.sp_sh	
class_spy_phase4_05	/Styles.Icon.command.sp_buff_stealth	
class_spy_phase4_master	/Styles.Icon.command.sp_dm	
class_medic_phase1_novice	/Styles.Icon.command.me_ae_heal	
class_medic_phase1_02	/Styles.Icon.command.me_dm	
class_medic_phase1_03	/Styles.Icon.command.me_dm_dot	
class_medic_phase1_04	/Styles.Icon.command.me_ae_heal	
class_medic_phase1_05	/Styles.Icon.command.me_dm	
class_medic_phase1_master	/Styles.Icon.command.me_dm	
class_medic_phase2_novice	/Styles.Icon.command.me_dm_dot	
class_medic_phase2_02	/Styles.Icon.command.me_dm_dot	
class_medic_phase2_03	/Styles.Icon.command.me_ae_heal	
class_medic_phase2_04	/Styles.Icon.command.me_hot	
class_medic_phase2_05	/Styles.Icon.command.me_fld_dm_dot	
class_medic_phase2_master	/Styles.Icon.command.me_dm	
class_medic_phase3_novice	/Styles.Icon.command.me_buff_health	
class_medic_phase3_02	/Styles.Icon.command.me_fld_dm_dot	
class_medic_phase3_03	/Styles.Icon.command.me_dm	
class_medic_phase3_04	/Styles.Icon.command.me_ae_heal	
class_medic_phase3_05	/Styles.Icon.command.me_hot	
class_medic_phase3_master	/Styles.Icon.command.me_dm	
class_medic_phase4_novice	/Styles.Icon.command.me_hot	
class_medic_phase4_02	/Styles.Icon.command.me_fld_dm_dot	
class_medic_phase4_03	/Styles.Icon.command.me_ae_heal	
class_medic_phase4_04	/Styles.Icon.command.me_sh	
class_medic_phase4_05	/Styles.Icon.command.me_dm	
class_medic_phase4_master	/Styles.Icon.command.me_ae_heal	
class_entertainer_phase1_novice	/Styles.icon.music.rock	
class_entertainer_phase1_02	/Styles.icon.music.basic	
class_entertainer_phase1_03	/Styles.Icon.music.starwars2	
class_entertainer_phase1_04	/Styles.icon.music.rhythmic	
class_entertainer_phase1_05	/Styles.icon.music.folk	
class_entertainer_phase1_master	/Styles.icon.music.footloose	
class_entertainer_phase2_novice	/Styles.icon.music.starwars3	
class_entertainer_phase2_02	/Styles.icon.music.formal	
class_entertainer_phase2_03	/Styles.icon.music.ceremonial	
class_entertainer_phase2_04	/Styles.icon.music.poplock	
class_entertainer_phase2_05	/Styles.icon.music.starwars4	
class_entertainer_phase2_master	/Styles.icon.music.popular	
class_entertainer_phase3_novice	/Styles.icon.music.ballad	
class_entertainer_phase3_02	/Styles.icon.music.bunduki	
class_entertainer_phase3_03	/Styles.icon.music.swing	
class_entertainer_phase3_04	/Styles.icon.music.tumble	
class_entertainer_phase3_05	/Styles.icon.music.funk	
class_entertainer_phase3_master	/Styles.icon.music.lyrical	
class_entertainer_phase4_novice	/Styles.icon.music.waltz	
class_entertainer_phase4_02	/Styles.icon.music.breakdance	
class_entertainer_phase4_03	/Styles.icon.music.jazz	
class_entertainer_phase4_04	/Styles.icon.music.exotic	
class_entertainer_phase4_05	/Styles.icon.music.virtuoso	
class_entertainer_phase4_master	/Styles.Icon.command.featuredSolo	
combat_1hsword_prereq_novice	/Styles.Icon.command.meleeStrike	1hsword
combat_1hsword_prereq_master	/Styles.Icon.command.legSweep	1hsword
combat_1hsword_prereq_01	/Styles.Icon.command.taunt	1hsword
combat_1hsword_prereq_02	/Styles.Icon.command.lunge	1hsword
combat_1hsword_prereq_03	/Styles.Icon.command.bleedAttack	1hsword
combat_1hsword_prereq_04	/Styles.Icon.command.centerOfBeing	1hsword
combat_1hsword_ability_01	/Styles.Icon.command.blindAttack	1hsword
combat_1hsword_ability_02	/Styles.Icon.command.blindRecovery	1hsword
combat_1hsword_ability_03	/Styles.Icon.command.blindAttack	1hsword
combat_1hsword_ability_04	/Styles.Icon.command.bodyHit	1hsword
combat_1hsword_accuracy_01	/Styles.Icon.command.scatterHit	1hsword
combat_1hsword_accuracy_02	/Styles.Icon.command.attack	1hsword
combat_1hsword_accuracy_03	/Styles.Icon.command.scatterHit	1hsword
combat_1hsword_accuracy_04	/Styles.Icon.command.stunRecovery	1hsword
combat_1hsword_master	/Styles.Icon.command.blindAttack	1hsword
combat_1hsword_novice	/Styles.Icon.command.bodyHit	1hsword
combat_1hsword_speed_01	/Styles.Icon.command.lunge	1hsword
combat_1hsword_speed_02	/Styles.Icon.command.crippleAttack	1hsword
combat_1hsword_speed_03	/Styles.Icon.command.dizzyRecovery	1hsword
combat_1hsword_speed_04	/Styles.Icon.command.crippleAttack	1hsword
combat_1hsword_support_01	/Styles.Icon.command.bleedAttack	1hsword
combat_1hsword_support_02	/Styles.Icon.command.bindingstrike	1hsword
combat_1hsword_support_03	/Styles.Icon.command.bleedAttack	1hsword
combat_1hsword_support_04	/Styles.Icon.command.bindingstrike	1hsword
combat_2hsword_prereq_novice	/Styles.Icon.command.meleeStrike	2hsword
combat_2hsword_prereq_master	/Styles.Icon.command.armorBreak	2hsword
combat_2hsword_prereq_01	/Styles.Icon.command.taunt	2hsword
combat_2hsword_prereq_02	/Styles.Icon.command.lunge	2hsword
combat_2hsword_prereq_03	/Styles.Icon.command.meleeAssault	2hsword
combat_2hsword_prereq_04	/Styles.Icon.command.centerOfBeing	2hsword
combat_2hsword_ability_01	/Styles.Icon.command.armorBreak	2hsword
combat_2hsword_ability_02	/Styles.Icon.command.swordFlurry	2hsword
combat_2hsword_ability_03	/Styles.Icon.command.armorBreak	2hsword
combat_2hsword_ability_04	/Styles.Icon.command.stunRecovery	2hsword
combat_2hsword_accuracy_01	/Styles.Icon.command.powerAttack	2hsword
combat_2hsword_accuracy_02	/Styles.Icon.command.berserk	2hsword
combat_2hsword_accuracy_03	/Styles.Icon.command.attack	2hsword
combat_2hsword_accuracy_04	/Styles.Icon.command.powerAttack	2hsword
combat_2hsword_master	/Styles.Icon.command.swordFlurry	2hsword
combat_2hsword_novice	/Styles.Icon.command.headHit	2hsword
combat_2hsword_speed_01	/Styles.Icon.command.areaTaunt	2hsword
combat_2hsword_speed_02	/Styles.Icon.command.blindRecovery	2hsword
combat_2hsword_speed_03	/Styles.Icon.command.areaTaunt	2hsword
combat_2hsword_speed_04	/Styles.Icon.command.headHit	2hsword
combat_2hsword_support_01	/Styles.Icon.command.criticalStrike	2hsword
combat_2hsword_support_02	/Styles.Icon.command.attack	2hsword
combat_2hsword_support_03	/Styles.Icon.command.dizzyRecovery	2hsword
combat_2hsword_support_04	/Styles.Icon.command.criticalStrike	2hsword
combat_bountyhunter_prereq_novice	/Styles.Icon.command.placedShot	combat
combat_bountyhunter_prereq_master	/Styles.Icon.command.duelistStance	combat
combat_bountyhunter_prereq_01	/Styles.Icon.command.ambush	combat
combat_bountyhunter_prereq_02	/Styles.Icon.command.crippleShot	combat
combat_bountyhunter_prereq_03	/Styles.Icon.command.assault	combat
combat_bountyhunter_prereq_04	/Styles.Icon.command.ambush	combat
combat_bountyhunter_droidcontrol_01	/Styles.Icon.command.criticalShot	combat
combat_bountyhunter_droidcontrol_02	/Styles.Icon.command.sprayShot	combat
combat_bountyhunter_droidcontrol_03	/Styles.Icon.command.criticalShot	combat
combat_bountyhunter_droidcontrol_04	/Styles.Icon.command.sprayShot	combat
combat_bountyhunter_droidresponse_01	/Styles.Icon.command.underHandShot	combat
combat_bountyhunter_droidresponse_02	/Styles.Icon.command.confusionShot	combat
combat_bountyhunter_droidresponse_03	/Styles.Icon.command.underHandShot	combat
combat_bountyhunter_droidresponse_04	/Styles.Icon.command.confusionShot	combat
combat_bountyhunter_investigation_01	/Styles.Icon.command.duelistStance	combat
combat_bountyhunter_investigation_02	/Styles.Icon.Roadmap.bounty_hunter	combat
combat_bountyhunter_investigation_03	/Styles.Icon.command.detonateDroid	combat
combat_bountyhunter_investigation_04	/Styles.Icon.command.duelistStance	combat
combat_bountyhunter_master	/Styles.Icon.command.criticalShot	combat
combat_bountyhunter_novice	/Styles.Icon.command.sniperShot	combat
combat_bountyhunter_support_01	/Styles.Icon.command.eyeShot	combat
combat_bountyhunter_support_02	/Styles.Icon.command.centerOfBeing	combat
combat_bountyhunter_support_03	/Styles.Icon.command.torsoShot	combat
combat_bountyhunter_support_04	/Styles.Icon.command.eyeShot	combat
combat_brawler_1handmelee_01	/Styles.Icon.command.lunge	1hsword
combat_brawler_1handmelee_02	/Styles.Icon.command.centerOfBeing	1hsword
combat_brawler_1handmelee_03	/Styles.Icon.command.meleeStrike	1hsword
combat_brawler_1handmelee_04	/Styles.Icon.command.bleedAttack	1hsword
combat_brawler_2handmelee_01	/Styles.Icon.command.meleeStrike	1hsword
combat_brawler_2handmelee_02	/Styles.Icon.command.lunge	1hsword
combat_brawler_2handmelee_03	/Styles.Icon.command.centerOfBeing	1hsword
combat_brawler_2handmelee_04	/Styles.Icon.command.armorBreak	1hsword
combat_brawler_master	/Styles.Icon.command.meleeAssault	combat
combat_brawler_novice	/Styles.Icon.command.taunt	combat
combat_brawler_polearm_01	/Styles.Icon.command.centerOfBeing	polearm
combat_brawler_polearm_02	/Styles.Icon.command.meleeStrike	polearm
combat_brawler_polearm_03	/Styles.Icon.command.lunge	polearm
combat_brawler_polearm_04	/Styles.Icon.command.sweepAttack	polearm
combat_brawler_unarmed_01	/Styles.Icon.command.centerOfBeing	unarmed
combat_brawler_unarmed_02	/Styles.Icon.command.meleeStrike	unarmed
combat_brawler_unarmed_03	/Styles.Icon.command.lunge	unarmed
combat_brawler_unarmed_04	/Styles.Icon.command.legSweep	unarmed
combat_carbine_prereq_novice	/Styles.Icon.command.placedShot	carbine
combat_carbine_prereq_master	/Styles.Icon.command.rapidFire	carbine
combat_carbine_prereq_01	/Styles.Icon.command.firearmStrike	carbine
combat_carbine_prereq_02	/Styles.Icon.command.aimedShot	carbine
combat_carbine_prereq_03	/Styles.Icon.command.kipUpShot	carbine
combat_carbine_prereq_04	/Styles.Icon.command.overchargeShot	carbine
combat_carbine_ability_01	/Styles.Icon.command.chargeShot	carbine
combat_carbine_ability_02	/Styles.Icon.command.suppressionFire	carbine
combat_carbine_ability_03	/Styles.Icon.command.chargeShot	carbine
combat_carbine_ability_04	/Styles.Icon.command.suppressionFire	carbine
combat_carbine_accuracy_01	/Styles.Icon.command.scatterShot	carbine
combat_carbine_accuracy_02	/Styles.Icon.command.fullAutoArea	carbine
combat_carbine_accuracy_03	/Styles.Icon.command.scatterShot	carbine
combat_carbine_accuracy_04	/Styles.Icon.command.fullAutoArea	carbine
combat_carbine_master	/Styles.Icon.command.rapidFire	carbine
combat_carbine_novice	/Styles.Icon.command.legShot	carbine
combat_carbine_speed_01	/Styles.Icon.command.cripplingShot	carbine
combat_carbine_speed_02	/Styles.Icon.command.rapidFire	carbine
combat_carbine_speed_03	/Styles.Icon.command.legShot	carbine
combat_carbine_speed_04	/Styles.Icon.command.cripplingShot	carbine
combat_carbine_support_01	/Styles.Icon.command.blindRecovery	carbine
combat_carbine_support_02	/Styles.Icon.command.consider	carbine
combat_carbine_support_03	/Styles.Icon.command.dizzyRecovery	carbine
combat_carbine_support_04	/Styles.Icon.command.stunRecovery	carbine
combat_commando_prereq_novice	/Styles.Icon.command.demolition	combat
combat_commando_prereq_01	/Styles.Icon.command.stunGrenade	combat
combat_commando_prereq_02	/Styles.Icon.command.barrage	combat
combat_commando_prereq_03	/Styles.Icon.command.demolition	combat
combat_commando_prereq_04	/Styles.Icon.command.barrage	combat
combat_commando_prereq_master	/Styles.Icon.command.stunGrenade	combat
combat_commando_heavyweapon_accuracy_01	/Styles.Icon.command.aim	combat
combat_commando_heavyweapon_accuracy_02	/Styles.Icon.command.aim	combat
combat_commando_heavyweapon_accuracy_03	/Styles.Icon.command.aim	combat
combat_commando_heavyweapon_accuracy_04	/Styles.Icon.command.aim	combat
combat_commando_heavyweapon_speed_01	/Styles.Icon.command.aimedshot	combat
combat_commando_heavyweapon_speed_02	/Styles.Icon.command.aimedshot	combat
combat_commando_heavyweapon_speed_03	/Styles.Icon.command.aimedshot	combat
combat_commando_heavyweapon_speed_04	/Styles.Icon.command.aimedshot	combat
combat_commando_master	/Styles.Icon.command.bodyHit	combat
combat_commando_novice	/Styles.Icon.command.torsoShot	combat
combat_commando_support_01	/Styles.Icon.command.restrainingshot	combat
combat_commando_support_02	/Styles.Icon.command.restrainingshot	combat
combat_commando_support_03	/Styles.Icon.command.restrainingshot	combat
combat_commando_support_04	/Styles.Icon.command.restrainingshot	combat
combat_commando_thrownweapon_01	/Styles.Icon.command.throwGrenade	combat
combat_commando_thrownweapon_02	/Styles.Icon.command.throwGrenade	combat
combat_commando_thrownweapon_03	/Styles.Icon.command.throwGrenade	combat
combat_commando_thrownweapon_04	/Styles.Icon.command.throwGrenade	combat
combat_marksman_carbine_01	/Styles.Icon.command.placedShot	carbine
combat_marksman_carbine_02	/Styles.Icon.command.firearmstrike	carbine
combat_marksman_carbine_03	/Styles.Icon.command.aimedshot	carbine
combat_marksman_carbine_04	/Styles.Icon.command.rapidFire	carbine
combat_marksman_master	/Styles.Icon.command.lethalShot	combat
combat_marksman_novice	/Styles.Icon.command.knockdownRecovery	pistol
combat_marksman_pistol_01	/Styles.Icon.command.firearmstrike	pistol
combat_marksman_pistol_02	/Styles.Icon.command.aimedshot	pistol
combat_marksman_pistol_03	/Styles.Icon.command.placedShot	pistol
combat_marksman_pistol_04	/Styles.Icon.command.quickDraw	pistol
combat_marksman_rifle_01	/Styles.Icon.command.aimedshot	rifle
combat_marksman_rifle_02	/Styles.Icon.command.placedShot	rifle
combat_marksman_rifle_03	/Styles.Icon.command.firearmstrike	rifle
combat_marksman_rifle_04	/Styles.Icon.command.aim	rifle
combat_marksman_support_01	/Styles.Icon.command.rollShot	combat
combat_marksman_support_02	/Styles.Icon.command.diveShot	combat
combat_marksman_support_03	/Styles.Icon.command.kipUpShot	combat
combat_marksman_support_04	/Styles.Icon.command.overchargeShot	combat
combat_pistol_prereq_novice	/Styles.Icon.command.placedShot	pistol
combat_pistol_prereq_master	/Styles.Icon.command.quickDraw	pistol
combat_pistol_prereq_01	/Styles.Icon.command.firearmStrike	pistol
combat_pistol_prereq_02	/Styles.Icon.command.aimedShot	pistol
combat_pistol_prereq_03	/Styles.Icon.command.kipUpShot	pistol
combat_pistol_prereq_04	/Styles.Icon.command.overchargeShot	pistol
combat_pistol_ability_01	/Styles.Icon.command.quickDraw	pistol
combat_pistol_ability_02	/Styles.Icon.command.dizzyRecovery	pistol
combat_pistol_ability_03	/Styles.Icon.command.intimidateShot	pistol
combat_pistol_ability_04	/Styles.Icon.command.stunRecovery	pistol
combat_pistol_accuracy_01	/Styles.Icon.command.firearmstrike	pistol
combat_pistol_accuracy_02	/Styles.Icon.command.warningShot	pistol
combat_pistol_accuracy_03	/Styles.Icon.command.firearmstrike	pistol
combat_pistol_accuracy_04	/Styles.Icon.command.bodyShot	pistol
combat_pistol_master	/Styles.Icon.command.quickDraw	pistol
combat_pistol_novice	/Styles.Icon.command.bodyShot	pistol
combat_pistol_speed_01	/Styles.Icon.command.burstShot	pistol
combat_pistol_speed_02	/Styles.Icon.command.disarmingShot	pistol
combat_pistol_speed_03	/Styles.Icon.command.burstShot	pistol
combat_pistol_speed_04	/Styles.Icon.command.disarmingShot	pistol
combat_pistol_support_01	/Styles.Icon.command.stoppingShot	pistol
combat_pistol_support_02	/Styles.Icon.command.fanshot	pistol
combat_pistol_support_03	/Styles.Icon.command.stoppingShot	pistol
combat_pistol_support_04	/Styles.Icon.command.fanshot	pistol
combat_polearm_prereq_novice	/Styles.Icon.command.meleeStrike	polearm
combat_polearm_prereq_master	/Styles.Icon.command.armorBreak	polearm
combat_polearm_prereq_01	/Styles.Icon.command.taunt	polearm
combat_polearm_prereq_02	/Styles.Icon.command.centerOfBeing	polearm
combat_polearm_prereq_03	/Styles.Icon.command.sweepAttack	polearm
combat_polearm_prereq_04	/Styles.Icon.command.lunge	polearm
combat_polearm_ability_01	/Styles.Icon.command.warcry	polearm
combat_polearm_ability_02	/Styles.Icon.command.blindRecovery	polearm
combat_polearm_ability_03	/Styles.Icon.command.intimidate	polearm
combat_polearm_ability_04	/Styles.Icon.command.warcry	polearm
combat_polearm_accuracy_01	/Styles.Icon.command.sweepAttack	polearm
combat_polearm_accuracy_02	/Styles.Icon.command.dizzyRecovery	polearm
combat_polearm_accuracy_03	/Styles.Icon.command.sweepAttack	polearm
combat_polearm_accuracy_04	/Styles.Icon.command.aim	polearm
combat_polearm_master	/Styles.Icon.command.impale	polearm
combat_polearm_novice	/Styles.Icon.command.legHit	polearm
combat_polearm_speed_01	/Styles.Icon.command.spinAttack	polearm
combat_polearm_speed_02	/Styles.Icon.command.impale	polearm
combat_polearm_speed_03	/Styles.Icon.command.spinAttack	polearm
combat_polearm_speed_04	/Styles.Icon.command.legHit	polearm
combat_polearm_support_01	/Styles.Icon.command.stunningBlow	polearm
combat_polearm_support_02	/Styles.Icon.command.aim	polearm
combat_polearm_support_03	/Styles.Icon.command.stunningBlow	polearm
combat_polearm_support_04	/Styles.Icon.command.stunRecovery	polearm
combat_rifleman_prereq_novice	/Styles.Icon.command.placedShot	rifle
combat_rifleman_prereq_master	/Styles.Icon.command.aim	rifle
combat_rifleman_prereq_01	/Styles.Icon.command.firearmStrike	rifle
combat_rifleman_prereq_02	/Styles.Icon.command.aimedShot	rifle
combat_rifleman_prereq_03	/Styles.Icon.command.kipUpShot	rifle
combat_rifleman_prereq_04	/Styles.Icon.command.overchargeShot	rifle
combat_rifleman_ability_01	/Styles.Icon.command.startleShot	rifle
combat_rifleman_ability_02	/Styles.Icon.command.dizzyRecovery	rifle
combat_rifleman_ability_03	/Styles.Icon.command.startleShot	rifle
combat_rifleman_ability_04	/Styles.Icon.command.kneecapShot	rifle
combat_rifleman_accuracy_01	/Styles.Icon.command.sniperShot	rifle
combat_rifleman_accuracy_02	/Styles.Icon.command.headShot	rifle
combat_rifleman_accuracy_03	/Styles.Icon.command.headShot	rifle
combat_rifleman_accuracy_04	/Styles.Icon.command.sniperShot	rifle
combat_rifleman_master	/Styles.Icon.command.startleShot	rifle
combat_rifleman_novice	/Styles.Icon.command.headShot	rifle
combat_rifleman_speed_01	/Styles.Icon.command.cover	rifle
combat_rifleman_speed_02	/Styles.Icon.command.concealShot	rifle
combat_rifleman_speed_03	/Styles.Icon.command.cover	rifle
combat_rifleman_speed_04	/Styles.Icon.command.concealShot	rifle
combat_rifleman_support_01	/Styles.Icon.command.aim	rifle
combat_rifleman_support_02	/Styles.Icon.command.blindRecovery	rifle
combat_rifleman_support_03	/Styles.Icon.command.aim	rifle
combat_rifleman_support_04	/Styles.Icon.command.stunRecovery	rifle
combat_smuggler_prereq_novice	/Styles.Icon.command.cheapShot	pistol
combat_smuggler_prereq_master	/Styles.Icon.command.blastAway	pistol
combat_smuggler_prereq_01	/Styles.Icon.command.hipShot	pistol
combat_smuggler_prereq_02	/Styles.Icon.command.blastAway	pistol
combat_smuggler_prereq_03	/Styles.Icon.command.cheapShot	pistol
combat_smuggler_prereq_04	/Styles.Icon.command.blastAway	pistol
combat_smuggler_combat_01	/Styles.Icon.command.feignDeath	pistol
combat_smuggler_combat_02	/Styles.Icon.command.dizzyRecovery	pistol
combat_smuggler_combat_03	/Styles.Icon.command.lowBlow	pistol
combat_smuggler_combat_04	/Styles.Icon.command.stunRecovery	pistol
combat_smuggler_master	/Styles.Icon.command.concussionShot	pistol
combat_smuggler_novice	/Styles.Icon.command.concussionShot	pistol
combat_smuggler_slicing_01	/Styles.Icon.command.installMissionTerminal	pistol
combat_smuggler_slicing_02	/Styles.Icon.command.overwhelmingShot	pistol
combat_smuggler_slicing_03	/Styles.Icon.buffs.armorHinderance	pistol
combat_smuggler_slicing_04	/Styles.Icon.command.overwhelmingShot	pistol
combat_smuggler_spice_01	/Styles.Icon.command.recklessshot	pistol
combat_smuggler_spice_02	/Styles.Icon.command.restrainingshot	pistol
combat_smuggler_spice_03	/Styles.Icon.command.recklessshot	pistol
combat_smuggler_spice_04	/Styles.Icon.command.restrainingshot	pistol
combat_smuggler_underworld_01	/Styles.Icon.command.panicShot	pistol
combat_smuggler_underworld_02	/Styles.Icon.command.blindRecovery	pistol
combat_smuggler_underworld_03	/Styles.Icon.command.panicShot	pistol
combat_smuggler_underworld_04	/Styles.Icon.command.lastDitch	pistol
combat_unarmed_prereq_novice	/Styles.Icon.command.forceStrike	unarmed
combat_unarmed_prereq_master	/Styles.Icon.command.forceFocus	unarmed
combat_unarmed_prereq_01	/Styles.Icon.command.forceFocus	unarmed
combat_unarmed_prereq_02	/Styles.Icon.command.centerOfBeing	unarmed
combat_unarmed_prereq_03	/Styles.Icon.command.forceStrike	unarmed
combat_unarmed_prereq_04	/Styles.Icon.command.centerOfBeing	unarmed
combat_unarmed_ability_01	/Styles.Icon.command.dizzyAttack	unarmed
combat_unarmed_ability_02	/Styles.Icon.command.taunt	unarmed
combat_unarmed_ability_03	/Styles.Icon.command.dizzyAttack	unarmed
combat_unarmed_ability_04	/Styles.Icon.command.taunt	unarmed
combat_unarmed_accuracy_01	/Styles.Icon.command.blindRecovery	unarmed
combat_unarmed_accuracy_02	/Styles.Icon.command.powerBoost	unarmed
combat_unarmed_accuracy_03	/Styles.Icon.command.dizzyRecovery	unarmed
combat_unarmed_accuracy_04	/Styles.Icon.command.forceOfWIll	unarmed
combat_unarmed_master	/Styles.Icon.command.dizzyAttack	unarmed
combat_unarmed_novice	/Styles.Icon.command.meditate	unarmed
combat_unarmed_speed_01	/Styles.Icon.command.centerOfBeing	unarmed
combat_unarmed_speed_02	/Styles.Icon.command.legSweep	unarmed
combat_unarmed_speed_03	/Styles.Icon.command.stunRecovery	unarmed
combat_unarmed_speed_04	/Styles.Icon.command.legSweep	unarmed
combat_unarmed_support_01	/Styles.Icon.command.comboAttack	unarmed
combat_unarmed_support_02	/Styles.Icon.command.taunt	unarmed
combat_unarmed_support_03	/Styles.Icon.command.comboAttack	unarmed
combat_unarmed_support_04	/Styles.Icon.command.taunt	unarmed
crafting_architect_blueprints_01	/Styles.Icon.Misc.genericSchematic	crafting
crafting_architect_blueprints_02	/Styles.Icon.Misc.genericSchematic	crafting
crafting_architect_blueprints_03	/Styles.Icon.Misc.genericSchematic	crafting
crafting_architect_blueprints_04	/Styles.Icon.Misc.genericSchematic	crafting
crafting_architect_harvesting_01	/Styles.Icon.Misc.genericSchematic	crafting
crafting_architect_harvesting_02	/Styles.Icon.Misc.genericSchematic	crafting
crafting_architect_harvesting_03	/Styles.Icon.Misc.genericSchematic	crafting
crafting_architect_harvesting_04	/Styles.Icon.Misc.genericSchematic	crafting
crafting_architect_master	/Styles.Icon.Misc.genericSchematic	crafting
crafting_architect_novice	/Styles.Icon.Misc.genericSchematic	crafting
crafting_architect_production_01	/Styles.Icon.command.consider	crafting
crafting_architect_production_02	/Styles.Icon.command.consider	crafting
crafting_architect_production_03	/Styles.Icon.command.consider	crafting
crafting_architect_production_04	/Styles.Icon.command.consider	crafting
crafting_architect_techniques_01	/Styles.Icon.Misc.genericSchematic	crafting
crafting_architect_techniques_02	/Styles.Icon.Misc.genericSchematic	crafting
crafting_architect_techniques_03	/Styles.Icon.Misc.genericSchematic	crafting
crafting_architect_techniques_04	/Styles.Icon.Misc.genericSchematic	crafting
crafting_armorsmith_complexity_01	/Styles.Icon.command.stabilizers	crafting
crafting_armorsmith_complexity_02	/Styles.Icon.command.stabilizers	crafting
crafting_armorsmith_complexity_03	/Styles.Icon.command.stabilizers	crafting
crafting_armorsmith_complexity_04	/Styles.Icon.command.stabilizers	crafting
crafting_armorsmith_deflectors_01	/Styles.Icon.Misc.genericArmor	crafting
crafting_armorsmith_deflectors_02	/Styles.Icon.Misc.genericArmor	crafting
crafting_armorsmith_deflectors_03	/Styles.Icon.Misc.genericArmor	crafting
crafting_armorsmith_deflectors_04	/Styles.Icon.Misc.genericArmor	crafting
crafting_armorsmith_heavy_01	/Styles.Icon.command.paralyze	crafting
crafting_armorsmith_heavy_02	/Styles.Icon.command.paralyze	crafting
crafting_armorsmith_heavy_03	/Styles.Icon.command.paralyze	crafting
crafting_armorsmith_heavy_04	/Styles.Icon.command.paralyze	crafting
crafting_armorsmith_master	/Styles.Icon.Misc.genericArmor	crafting
crafting_armorsmith_novice	/Styles.Icon.Misc.genericArmor	crafting
crafting_armorsmith_personal_01	/Styles.Icon.Misc.genericArmor	crafting
crafting_armorsmith_personal_02	/Styles.Icon.Misc.genericArmor	crafting
crafting_armorsmith_personal_03	/Styles.Icon.Misc.genericArmor	crafting
crafting_armorsmith_personal_04	/Styles.Icon.Misc.genericArmor	crafting
crafting_artisan_business_01	/Styles.Icon.Misc.genericSchematic	crafting
crafting_artisan_business_02	/Styles.Icon.Misc.genericSchematic	crafting
crafting_artisan_business_03	/Styles.Icon.Misc.genericSchematic	crafting
crafting_artisan_business_04	/Styles.Icon.Misc.genericSchematic	crafting
crafting_artisan_domestic_01	/Styles.Icon.Misc.genericSchematic	crafting
crafting_artisan_domestic_02	/Styles.Icon.Misc.genericSchematic	crafting
crafting_artisan_domestic_03	/Styles.Icon.Misc.genericSchematic	crafting
crafting_artisan_domestic_04	/Styles.Icon.Misc.genericSchematic	crafting
crafting_artisan_engineering_01	/Styles.Icon.command.consider	crafting
crafting_artisan_engineering_02	/Styles.Icon.command.consider	crafting
crafting_artisan_engineering_03	/Styles.Icon.command.consider	crafting
crafting_artisan_engineering_04	/Styles.Icon.command.consider	crafting
crafting_artisan_master	/Styles.Icon.Misc.genericSchematic	crafting
crafting_artisan_novice	/Styles.Icon.Misc.genericSchematic	crafting
crafting_artisan_survey_01	/Styles.Icon.command.disarmTrap	crafting
crafting_artisan_survey_02	/Styles.Icon.command.disarmTrap	crafting
crafting_artisan_survey_03	/Styles.Icon.command.disarmTrap	crafting
crafting_artisan_survey_04	/Styles.Icon.command.disarmTrap	crafting
crafting_chef_dessert_01	/Styles.Icon.buffs.foodDessert	crafting
crafting_chef_dessert_02	/Styles.Icon.buffs.foodDessert	crafting
crafting_chef_dessert_03	/Styles.Icon.buffs.foodDessert	crafting
crafting_chef_dessert_04	/Styles.Icon.buffs.foodDessert	crafting
crafting_chef_dish_01	/Styles.Icon.buffs.foodMeal	crafting
crafting_chef_dish_02	/Styles.Icon.buffs.foodMeal	crafting
crafting_chef_dish_03	/Styles.Icon.buffs.foodMeal	crafting
crafting_chef_dish_04	/Styles.Icon.buffs.foodMeal	crafting
crafting_chef_drink_01	/Styles.Icon.buffs.foodBeverage	crafting
crafting_chef_drink_02	/Styles.Icon.buffs.foodBeverage	crafting
crafting_chef_drink_03	/Styles.Icon.buffs.foodBeverage	crafting
crafting_chef_drink_04	/Styles.Icon.buffs.foodBeverage	crafting
crafting_chef_master	/Styles.Icon.buffs.foodMeal	crafting
crafting_chef_novice	/Styles.Icon.buffs.foodMeal	crafting
crafting_chef_techniques_01	/Styles.Icon.buffs.foodVegetable	crafting
crafting_chef_techniques_02	/Styles.Icon.buffs.foodVegetable	crafting
crafting_chef_techniques_03	/Styles.Icon.buffs.foodVegetable	crafting
crafting_chef_techniques_04	/Styles.Icon.buffs.foodVegetable	crafting
crafting_droidengineer_blueprints_01	/Styles.Icon.Misc.genericSchematic	crafting
crafting_droidengineer_blueprints_02	/Styles.Icon.Misc.genericSchematic	crafting
crafting_droidengineer_blueprints_03	/Styles.Icon.Misc.genericSchematic	crafting
crafting_droidengineer_blueprints_04	/Styles.Icon.Misc.genericSchematic	crafting
crafting_droidengineer_master	/Styles.Icon.command.detonateDroid	crafting
crafting_droidengineer_novice	/Styles.Icon.command.detonateDroid	crafting
crafting_droidengineer_production_01	/Styles.Icon.Misc.genericSchematic	crafting
crafting_droidengineer_production_02	/Styles.Icon.Misc.genericSchematic	crafting
crafting_droidengineer_production_03	/Styles.Icon.Misc.genericSchematic	crafting
crafting_droidengineer_production_04	/Styles.Icon.Misc.genericSchematic	crafting
crafting_droidengineer_refinement_01	/Styles.Icon.Misc.genericSchematic	crafting
crafting_droidengineer_refinement_02	/Styles.Icon.Misc.genericSchematic	crafting
crafting_droidengineer_refinement_03	/Styles.Icon.Misc.genericSchematic	crafting
crafting_droidengineer_refinement_04	/Styles.Icon.Misc.genericSchematic	crafting
crafting_droidengineer_techniques_01	/Styles.Icon.Misc.genericSchematic	crafting
crafting_droidengineer_techniques_02	/Styles.Icon.Misc.genericSchematic	crafting
crafting_droidengineer_techniques_03	/Styles.Icon.Misc.genericSchematic	crafting
crafting_droidengineer_techniques_04	/Styles.Icon.Misc.genericSchematic	crafting
crafting_merchant_advertising_01	/Styles.Icon.Misc.genericInstrument	crafting
crafting_merchant_advertising_02	/Styles.Icon.Misc.genericInstrument	crafting
crafting_merchant_advertising_03	/Styles.Icon.Misc.genericInstrument	crafting
crafting_merchant_advertising_04	/Styles.Icon.Misc.genericInstrument	crafting
crafting_merchant_hiring_01	/Styles.Icon.command.sysGroup	crafting
crafting_merchant_hiring_02	/Styles.Icon.command.sysGroup	crafting
crafting_merchant_hiring_03	/Styles.Icon.command.sysGroup	crafting
crafting_merchant_hiring_04	/Styles.Icon.command.sysGroup	crafting
crafting_merchant_management_01	/Styles.Icon.command.dragPlayer	crafting
crafting_merchant_management_02	/Styles.Icon.command.dragPlayer	crafting
crafting_merchant_management_03	/Styles.Icon.command.dragPlayer	crafting
crafting_merchant_management_04	/Styles.Icon.command.dragPlayer	crafting
crafting_merchant_master	/Styles.Icon.command.covercharge	crafting
crafting_merchant_novice	/Styles.Icon.command.covercharge	crafting
crafting_merchant_sales_01	/Styles.Icon.command.covercharge	crafting
crafting_merchant_sales_02	/Styles.Icon.command.covercharge	crafting
crafting_merchant_sales_03	/Styles.Icon.command.covercharge	crafting
crafting_merchant_sales_04	/Styles.Icon.command.covercharge	crafting
crafting_shipwright_defense_01	/Styles.Icon.Misc.genericArmor	crafting
crafting_shipwright_defense_02	/Styles.Icon.Misc.genericArmor	crafting
crafting_shipwright_defense_03	/Styles.Icon.Misc.genericArmor	crafting
crafting_shipwright_defense_04	/Styles.Icon.Misc.genericArmor	crafting
crafting_shipwright_engineering_01	/Styles.Icon.Misc.genericSchematic	crafting
crafting_shipwright_engineering_02	/Styles.Icon.Misc.genericSchematic	crafting
crafting_shipwright_engineering_03	/Styles.Icon.Misc.genericSchematic	crafting
crafting_shipwright_engineering_04	/Styles.Icon.Misc.genericSchematic	crafting
crafting_shipwright_master	/Styles.Icon.Misc.genericSchematic	crafting
crafting_shipwright_novice	/Styles.Icon.Misc.genericSchematic	crafting
crafting_shipwright_propulsion_01	/Styles.Icon.Misc.genericSchematic	crafting
crafting_shipwright_propulsion_02	/Styles.Icon.Misc.genericSchematic	crafting
crafting_shipwright_propulsion_03	/Styles.Icon.Misc.genericSchematic	crafting
crafting_shipwright_propulsion_04	/Styles.Icon.Misc.genericSchematic	crafting
crafting_shipwright_systems_01	/Styles.Icon.Misc.genericSchematic	crafting
crafting_shipwright_systems_02	/Styles.Icon.Misc.genericSchematic	crafting
crafting_shipwright_systems_03	/Styles.Icon.Misc.genericSchematic	crafting
crafting_shipwright_systems_04	/Styles.Icon.Misc.genericSchematic	crafting
crafting_tailor_casual_01	/Styles.Icon.music.breakdance	crafting
crafting_tailor_casual_02	/Styles.Icon.music.breakdance	crafting
crafting_tailor_casual_03	/Styles.Icon.music.breakdance	crafting
crafting_tailor_casual_04	/Styles.Icon.music.breakdance	crafting
crafting_tailor_field_01	/Styles.Icon.Misc.genericArmor	crafting
crafting_tailor_field_02	/Styles.Icon.Misc.genericArmor	crafting
crafting_tailor_field_03	/Styles.Icon.Misc.genericArmor	crafting
crafting_tailor_field_04	/Styles.Icon.Misc.genericArmor	crafting
crafting_tailor_formal_01	/Styles.Icon.music.bunduki	crafting
crafting_tailor_formal_02	/Styles.Icon.music.bunduki	crafting
crafting_tailor_formal_03	/Styles.Icon.music.bunduki	crafting
crafting_tailor_formal_04	/Styles.Icon.music.bunduki	crafting
crafting_tailor_master	/Styles.Icon.music.bunduki	crafting
crafting_tailor_novice	/Styles.Icon.music.breakdance	crafting
crafting_tailor_production_01	/Styles.Icon.Misc.genericSchematic	crafting
crafting_tailor_production_02	/Styles.Icon.Misc.genericSchematic	crafting
crafting_tailor_production_03	/Styles.Icon.Misc.genericSchematic	crafting
crafting_tailor_production_04	/Styles.Icon.Misc.genericSchematic	crafting
crafting_weaponsmith_firearms_01	/Styles.Icon.command.rangedShot	crafting
crafting_weaponsmith_firearms_02	/Styles.Icon.command.rangedShot	crafting
crafting_weaponsmith_firearms_03	/Styles.Icon.command.rangedShot	crafting
crafting_weaponsmith_firearms_04	/Styles.Icon.command.rangedShot	crafting
crafting_weaponsmith_master	/Styles.Icon.command.meleeStrike	crafting
crafting_weaponsmith_melee_01	/Styles.Icon.command.meleeHit	crafting
crafting_weaponsmith_melee_02	/Styles.Icon.command.meleeHit	crafting
crafting_weaponsmith_melee_03	/Styles.Icon.command.meleeHit	crafting
crafting_weaponsmith_melee_04	/Styles.Icon.command.meleeHit	crafting
crafting_weaponsmith_munitions_01	/Styles.Icon.command.placedShot	crafting
crafting_weaponsmith_munitions_02	/Styles.Icon.command.placedShot	crafting
crafting_weaponsmith_munitions_03	/Styles.Icon.command.placedShot	crafting
crafting_weaponsmith_munitions_04	/Styles.Icon.command.placedShot	crafting
crafting_weaponsmith_novice	/Styles.Icon.Misc.genericSchematic	crafting
crafting_weaponsmith_techniques_01	/Styles.Icon.Misc.genericSchematic	crafting
crafting_weaponsmith_techniques_02	/Styles.Icon.Misc.genericSchematic	crafting
crafting_weaponsmith_techniques_03	/Styles.Icon.Misc.genericSchematic	crafting
crafting_weaponsmith_techniques_04	/Styles.Icon.Misc.genericSchematic	crafting
outdoors_bio_engineer_creature_01	/Styles.Icon.command.trainPet	crafting
outdoors_bio_engineer_creature_02	/Styles.Icon.command.trainPet	crafting
outdoors_bio_engineer_creature_03	/Styles.Icon.command.trainPet	crafting
outdoors_bio_engineer_creature_04	/Styles.Icon.command.trainPet	crafting
outdoors_bio_engineer_dna_harvesting_01	/Styles.Icon.command.petFrenzy	crafting
outdoors_bio_engineer_dna_harvesting_02	/Styles.Icon.command.petFrenzy	crafting
outdoors_bio_engineer_dna_harvesting_03	/Styles.Icon.command.petFrenzy	crafting
outdoors_bio_engineer_dna_harvesting_04	/Styles.Icon.command.petFrenzy	crafting
outdoors_bio_engineer_master	/Styles.Icon.command.trainPet	crafting
outdoors_bio_engineer_novice	/Styles.Icon.command.trainPet	crafting
outdoors_bio_engineer_production_01	/Styles.Icon.command.petShield	crafting
outdoors_bio_engineer_production_02	/Styles.Icon.command.petShield	crafting
outdoors_bio_engineer_production_03	/Styles.Icon.command.petShield	crafting
outdoors_bio_engineer_production_04	/Styles.Icon.command.petShield	crafting
outdoors_bio_engineer_tissue_01	/Styles.Icon.command.petBleedAttack	crafting
outdoors_bio_engineer_tissue_02	/Styles.Icon.command.petBleedAttack	crafting
outdoors_bio_engineer_tissue_03	/Styles.Icon.command.petBleedAttack	crafting
outdoors_bio_engineer_tissue_04	/Styles.Icon.command.petBleedAttack	crafting
outdoors_ranger_prereq_novice	/Styles.Icon.command.placedShot	combat
outdoors_ranger_prereq_master	/Styles.Icon.command.rapidFire	combat
outdoors_ranger_prereq_01	/Styles.Icon.command.smokeGrenade	combat
outdoors_ranger_prereq_02	/Styles.Icon.command.stealth	combat
outdoors_ranger_prereq_03	/Styles.Icon.command.terminateTarget	combat
outdoors_ranger_prereq_04	/Styles.Icon.command.stealth	combat
outdoors_ranger_harvest_01	/Styles.Icon.command.blendIn	combat
outdoors_ranger_harvest_02	/Styles.Icon.command.blendIn	combat
outdoors_ranger_harvest_03	/Styles.Icon.command.blendIn	combat
outdoors_ranger_harvest_04	/Styles.Icon.command.blendIn	combat
outdoors_ranger_master	/Styles.Icon.command.urbanStealth	combat
outdoors_ranger_movement_01	/Styles.Icon.command.camouflageSelf	combat
outdoors_ranger_movement_02	/Styles.Icon.command.camouflageAlly	combat
outdoors_ranger_movement_03	/Styles.Icon.command.camouflageSelf	combat
outdoors_ranger_movement_04	/Styles.Icon.command.camouflageAlly	combat
outdoors_ranger_novice	/Styles.Icon.command.blendIn	combat
outdoors_ranger_support_01	/Styles.Icon.command.blendIn	combat
outdoors_ranger_support_02	/Styles.Icon.command.detectCamouflage	combat
outdoors_ranger_support_03	/Styles.Icon.command.detectCamouflage	combat
outdoors_ranger_support_04	/Styles.Icon.command.disarmTrap	combat
outdoors_ranger_tracking_01	/Styles.Icon.command.wildernessStealth	combat
outdoors_ranger_tracking_02	/Styles.Icon.command.wildernessStealth	combat
outdoors_ranger_tracking_03	/Styles.Icon.command.incognito	combat
outdoors_ranger_tracking_04	/Styles.Icon.command.wildernessStealth	combat
outdoors_scout_camp_01	/Styles.Icon.command.petDefense	combat
outdoors_scout_camp_02	/Styles.Icon.command.petDefense	combat
outdoors_scout_camp_03	/Styles.Icon.command.petDefense	combat
outdoors_scout_camp_04	/Styles.Icon.command.petDefense	combat
outdoors_scout_harvest_01	/Styles.Icon.command.forage	combat
outdoors_scout_harvest_02	/Styles.Icon.command.forage	combat
outdoors_scout_harvest_03	/Styles.Icon.command.forage	combat
outdoors_scout_harvest_04	/Styles.Icon.command.forage	combat
outdoors_scout_master	/Styles.Icon.command.forage	combat
outdoors_scout_movement_01	/Styles.Icon.command.burstRun	combat
outdoors_scout_movement_02	/Styles.Icon.command.maskScent	combat
outdoors_scout_movement_03	/Styles.Icon.command.burstRun	combat
outdoors_scout_movement_04	/Styles.Icon.command.burstRun	combat
outdoors_scout_novice	/Styles.Icon.command.throwGrenade	combat
outdoors_scout_tools_01	/Styles.Icon.command.throwGrenade	combat
outdoors_scout_tools_02	/Styles.Icon.command.throwGrenade	combat
outdoors_scout_tools_03	/Styles.Icon.command.throwGrenade	combat
outdoors_scout_tools_04	/Styles.Icon.command.throwGrenade	combat
outdoors_squadleader_prereq_novice	/Styles.Icon.command.actOfWar	combat
outdoors_squadleader_prereq_master	/Styles.Icon.command.paintTarget	combat
outdoors_squadleader_prereq_01	/Styles.Icon.command.paintTarget	combat
outdoors_squadleader_prereq_02	/Styles.Icon.command.entrench	combat
outdoors_squadleader_prereq_03	/Styles.Icon.command.actOfWar	combat
outdoors_squadleader_prereq_04	/Styles.Icon.command.entrench	combat
outdoors_squadleader_defense_01	/Styles.Icon.command.formup	combat
outdoors_squadleader_defense_02	/Styles.Icon.command.formup	combat
outdoors_squadleader_defense_03	/Styles.Icon.command.formup	combat
outdoors_squadleader_defense_04	/Styles.Icon.command.boostMorale	combat
outdoors_squadleader_master	/Styles.Icon.command.sysGroup	combat
outdoors_squadleader_movement_01	/Styles.Icon.command.burstRun	combat
outdoors_squadleader_movement_02	/Styles.Icon.command.burstRun	combat
outdoors_squadleader_movement_03	/Styles.Icon.command.burstRun	combat
outdoors_squadleader_movement_04	/Styles.Icon.command.burstRun	combat
outdoors_squadleader_novice	/Styles.Icon.command.sysGroup	combat
outdoors_squadleader_offense_01	/Styles.Icon.command.steadyAim	combat
outdoors_squadleader_offense_02	/Styles.Icon.command.steadyAim	combat
outdoors_squadleader_offense_03	/Styles.Icon.command.volleyFire	combat
outdoors_squadleader_offense_04	/Styles.Icon.command.volleyFire	combat
outdoors_squadleader_support_01	/Styles.Icon.command.taunt	combat
outdoors_squadleader_support_02	/Styles.Icon.command.taunt	combat
outdoors_squadleader_support_03	/Styles.Icon.command.retreat	combat
outdoors_squadleader_support_04	/Styles.Icon.command.retreat	combat
phase	/Styles.Icon.role.utility	medic
science_combatmedic_prereq_novice	/Styles.Icon.command.bactaShot	medic
science_combatmedic_prereq_master	/Styles.Icon.command.bactaSpray	medic
science_combatmedic_prereq_01	/Styles.Icon.command.rollShot	medic
science_combatmedic_prereq_02	/Styles.Icon.command.kipUpShot	medic
science_combatmedic_prereq_03	/Styles.Icon.command.bactaToss	medic
science_combatmedic_prereq_04	/Styles.Icon.command.overchargeShot	medic
science_combatmedic_healing_range_01	/Styles.Icon.command.bactaToss	medic
science_combatmedic_healing_range_02	/Styles.Icon.command.bactaSpray	medic
science_combatmedic_healing_range_03	/Styles.Icon.command.bactaToss	medic
science_combatmedic_healing_range_04	/Styles.Icon.command.bactaSpray	medic
science_combatmedic_healing_range_speed_01	/Styles.Icon.command.infect	medic
science_combatmedic_healing_range_speed_02	/Styles.Icon.command.deuteriumToss	medic
science_combatmedic_healing_range_speed_03	/Styles.Icon.command.infect	medic
science_combatmedic_healing_range_speed_04	/Styles.Icon.command.deuteriumToss	medic
science_combatmedic_master	/Styles.Icon.command.resuscitatePlayer	medic
science_combatmedic_medicine_01	/Styles.Icon.command.hemorrhage	medic
science_combatmedic_medicine_02	/Styles.Icon.command.shock	medic
science_combatmedic_medicine_03	/Styles.Icon.command.hemorrhage	medic
science_combatmedic_medicine_04	/Styles.Icon.command.shock	medic
science_combatmedic_novice	/Styles.Icon.command.neurotoxin	medic
science_combatmedic_support_01	/Styles.Icon.command.electrolyteDrain	medic
science_combatmedic_support_02	/Styles.Icon.command.thyroidRupture	medic
science_combatmedic_support_03	/Styles.Icon.command.paralyze	medic
science_combatmedic_support_04	/Styles.Icon.command.thyroidRupture	medic
science_doctor_prereq_novice	/Styles.Icon.command.targetAnatomy	medic
science_doctor_prereq_master	/Styles.Icon.command.bactaSpray	medic
science_doctor_prereq_01	/Styles.Icon.command.bactaSpray	medic
science_doctor_prereq_02	/Styles.Icon.command.neuroToxin	medic
science_doctor_prereq_03	/Styles.Icon.command.targetAnatomy	medic
science_doctor_prereq_04	/Styles.Icon.command.neuroToxin	medic
science_doctor_ability_01	/Styles.Icon.command.poisonInnoculation	medic
science_doctor_ability_02	/Styles.Icon.command.diseaseInnoculation	medic
science_doctor_ability_03	/Styles.Icon.command.poisonInnoculation	medic
science_doctor_ability_04	/Styles.Icon.command.diseaseInnoculation	medic
science_doctor_master	/Styles.Icon.command.revivePlayer	medic
science_doctor_novice	/Styles.Icon.command.bactaJab	medic
science_doctor_support_01	/Styles.Icon.command.endorphineInjection	medic
science_doctor_support_02	/Styles.Icon.command.adrenalBoost	medic
science_doctor_support_03	/Styles.Icon.command.endorphineInjection	medic
science_doctor_support_04	/Styles.Icon.command.serotoninInjection	medic
science_doctor_wound_01	/Styles.Icon.command.bandage	medic
science_doctor_wound_02	/Styles.Icon.command.disinfect	medic
science_doctor_wound_03	/Styles.Icon.command.counterToxin	medic
science_doctor_wound_04	/Styles.Icon.command.disinfect	medic
science_doctor_wound_speed_01	/Styles.Icon.command.bactaInfusion	medic
science_doctor_wound_speed_02	/Styles.Icon.command.bactaShot	medic
science_doctor_wound_speed_03	/Styles.Icon.command.bactaJab	medic
science_doctor_wound_speed_04	/Styles.Icon.command.bactaInfusion	medic
science_medic_ability_01	/Styles.Icon.buffs.genericBuff	medic
science_medic_ability_02	/Styles.Icon.command.diagnose	medic
science_medic_ability_03	/Styles.Icon.buffs.genericBuff	medic
science_medic_ability_04	/Styles.Icon.command.dragincapacitatedplayer	medic
science_medic_crafting_01	/Styles.Icon.buffs.genericBuff	medic
science_medic_crafting_02	/Styles.Icon.buffs.genericBuff	medic
science_medic_crafting_03	/Styles.Icon.buffs.genericBuff	medic
science_medic_crafting_04	/Styles.Icon.buffs.genericBuff	medic
science_medic_injury_01	/Styles.Icon.buffs.genericBuff	medic
science_medic_injury_02	/Styles.Icon.command.stabilizers	medic
science_medic_injury_03	/Styles.Icon.command.stabilizers	medic
science_medic_injury_04	/Styles.Icon.command.nutrientInjection	medic
science_medic_injury_speed_01	/Styles.Icon.command.bactaJab	medic
science_medic_injury_speed_02	/Styles.Icon.command.bactaToss	medic
science_medic_injury_speed_03	/Styles.Icon.command.bactaToss	medic
science_medic_injury_speed_04	/Styles.Icon.command.bactaSpray	medic
science_medic_master	/Styles.Icon.command.serotoninInjection	medic
science_medic_novice	/Styles.Icon.command.bactaShot	medic
social_dancer_ability_01	/Styles.Icon.command.dazzle	dance
social_dancer_ability_02	/Styles.Icon.command.colorSwirl	dance
social_dancer_ability_03	/Styles.Icon.command.centerStage	dance
social_dancer_ability_04	/Styles.Icon.command.floorLights	dance
social_dancer_knowledge_01	/Styles.Icon.music.popular	dance
social_dancer_knowledge_02	/Styles.Icon.music.poplock	dance
social_dancer_knowledge_03	/Styles.Icon.music.lyrical	dance
social_dancer_knowledge_04	/Styles.Icon.music.breakdance	dance
social_dancer_master	/Styles.Icon.music.exotic	dance
social_dancer_novice	/Styles.Icon.music.bunduki	dance
social_dancer_shock_01	/Styles.Icon.music.dance_flourish5	dance
social_dancer_shock_02	/Styles.Icon.music.dance_flourish6	dance
social_dancer_shock_03	/Styles.Icon.music.dance_flourish7	dance
social_dancer_shock_04	/Styles.Icon.music.dance_flourish8	dance
social_dancer_wound_01	/Styles.Icon.music.dance_flourish1	dance
social_dancer_wound_02	/Styles.Icon.music.dance_flourish2	dance
social_dancer_wound_03	/Styles.Icon.music.dance_flourish3	dance
social_dancer_wound_04	/Styles.Icon.music.dance_flourish4	dance
social_entertainer_dance_01	/Styles.Icon.music.basic	dance
social_entertainer_dance_02	/Styles.Icon.music.rhythmic	dance
social_entertainer_dance_03	/Styles.Icon.music.footloose	dance
social_entertainer_dance_04	/Styles.Icon.music.formal	dance
social_entertainer_hairstyle_01	/Styles.Icon.command.imageDesign	entertain
social_entertainer_hairstyle_02	/Styles.Icon.command.imageDesign	entertain
social_entertainer_hairstyle_03	/Styles.Icon.command.imageDesign	entertain
social_entertainer_hairstyle_04	/Styles.Icon.command.imageDesign	entertain
social_entertainer_healing_01	/Styles.Icon.Misc.genericInstrument	entertain
social_entertainer_healing_02	/Styles.Icon.Misc.genericInstrument	entertain
social_entertainer_healing_03	/Styles.Icon.Misc.genericInstrument	entertain
social_entertainer_healing_04	/Styles.Icon.Misc.genericInstrument	entertain
social_entertainer_master	/Styles.Icon.music.ceremonial	entertain
social_entertainer_music_01	/Styles.Icon.music.rock	music
social_entertainer_music_02	/Styles.Icon.music.starwars2	music
social_entertainer_music_03	/Styles.Icon.music.folk	music
social_entertainer_music_04	/Styles.Icon.music.starwars3	music
social_entertainer_novice	/Styles.Icon.command.inspire	music
social_imagedesigner_bodyform_01	/Styles.Icon.command.imageDesign	entertain
social_imagedesigner_bodyform_02	/Styles.Icon.command.imageDesign	entertain
social_imagedesigner_bodyform_03	/Styles.Icon.command.imageDesign	entertain
social_imagedesigner_bodyform_04	/Styles.Icon.command.imageDesign	entertain
social_imagedesigner_exotic_01	/Styles.Icon.command.imageDesign	entertain
social_imagedesigner_exotic_02	/Styles.Icon.command.imageDesign	entertain
social_imagedesigner_exotic_03	/Styles.Icon.command.imageDesign	entertain
social_imagedesigner_exotic_04	/Styles.Icon.command.imageDesign	entertain
social_imagedesigner_hairstyle_01	/Styles.Icon.command.imageDesign	entertain
social_imagedesigner_hairstyle_02	/Styles.Icon.command.imageDesign	entertain
social_imagedesigner_hairstyle_03	/Styles.Icon.command.imageDesign	entertain
social_imagedesigner_hairstyle_04	/Styles.Icon.command.imageDesign	entertain
social_imagedesigner_markings_01	/Styles.Icon.command.imageDesign	entertain
social_imagedesigner_markings_02	/Styles.Icon.command.imageDesign	entertain
social_imagedesigner_markings_03	/Styles.Icon.command.imageDesign	entertain
social_imagedesigner_markings_04	/Styles.Icon.command.imageDesign	entertain
social_imagedesigner_master	/Styles.Icon.command.imageDesign	entertain
social_imagedesigner_novice	/Styles.Icon.command.imageDesign	entertain
social_musician_ability_01	/Styles.Icon.command.spotlight	music
social_musician_ability_02	/Styles.Icon.command.laserShow	music
social_musician_ability_03	/Styles.Icon.command.firejet2	music
social_musician_ability_04	/Styles.Icon.command.featuredSolo	music
social_musician_knowledge_01	/Styles.Icon.music.ballad	music
social_musician_knowledge_02	/Styles.Icon.music.funk	music
social_musician_knowledge_03	/Styles.Icon.music.waltz	music
social_musician_knowledge_04	/Styles.Icon.music.jazz	music
social_musician_master	/Styles.Icon.music.virtuoso	music
social_musician_novice	/Styles.Icon.music.starwars4	music
social_musician_shock_01	/Styles.Icon.Misc.genericInstrument	music
social_musician_shock_02	/Styles.Icon.Misc.genericInstrument	music
social_musician_shock_03	/Styles.Icon.Misc.genericInstrument	music
social_musician_shock_04	/Styles.Icon.Misc.genericInstrument	music
social_musician_wound_01	/Styles.Icon.command.inspire	music
social_musician_wound_02	/Styles.Icon.command.inspire	music
social_musician_wound_03	/Styles.Icon.command.inspire	music
social_musician_wound_04	/Styles.Icon.command.inspire	music
pilot_rebel_navy_novice	/Styles.space.Icon.droid.droidMuteDroid	space
pilot_rebel_navy_master	/Styles.space.Icon.command.jstart3	space
pilot_rebel_navy_starships_01	/Styles.space.Icon.command.ptrap1	space
pilot_rebel_navy_starships_02	/Styles.space.Icon.command.ptrap2	space
pilot_rebel_navy_starships_03	/Styles.space.Icon.command.ptrap1	space
pilot_rebel_navy_starships_04	/Styles.space.Icon.command.ptrap2	space
pilot_rebel_navy_weapons_01	/Styles.space.Icon.command.nblast	space
pilot_rebel_navy_weapons_02	/Styles.space.Icon.command.nblast	space
pilot_rebel_navy_weapons_03	/Styles.space.Icon.command.nblast	space
pilot_rebel_navy_weapons_04	/Styles.space.Icon.command.nblast	space
pilot_rebel_navy_procedures_01	/Styles.space.Icon.command.iffScramble	space
pilot_rebel_navy_procedures_02	/Styles.space.Icon.command.eshields	space
pilot_rebel_navy_procedures_03	/Styles.space.Icon.command.inspacerepair	space
pilot_rebel_navy_procedures_04	/Styles.space.Icon.command.inspacereload	space
pilot_rebel_navy_droid_01	/Styles.space.Icon.droid.droidShieldNormalize	space
pilot_rebel_navy_droid_02	/Styles.space.Icon.droid.droidShieldAdjustFrontOne	space
pilot_rebel_navy_droid_03	/Styles.space.Icon.droid.droidShieldAdjustFrontThree	space
pilot_rebel_navy_droid_04	/Styles.space.Icon.droid.droidShieldEmergencyFront	space
pilot_imperial_navy_novice	/Styles.space.Icon.droid.droidMuteDroid	space
pilot_imperial_navy_master	/Styles.space.Icon.command.bstrike3	space
pilot_imperial_navy_starships_01	/Styles.space.Icon.command.bstrike1	space
pilot_imperial_navy_starships_02	/Styles.space.Icon.command.bstrike1	space
pilot_imperial_navy_starships_03	/Styles.space.Icon.command.bstrike1	space
pilot_imperial_navy_starships_04	/Styles.space.Icon.command.bstrike1	space
pilot_imperial_navy_weapons_01	/Styles.space.Icon.command.nblast	space
pilot_imperial_navy_weapons_02	/Styles.space.Icon.command.nblast	space
pilot_imperial_navy_weapons_03	/Styles.space.Icon.command.nblast	space
pilot_imperial_navy_weapons_04	/Styles.space.Icon.command.nblast	space
pilot_imperial_navy_procedures_01	/Styles.space.Icon.command.pumpReactor	space
pilot_imperial_navy_procedures_02	/Styles.space.Icon.command.eweapons	space
pilot_imperial_navy_procedures_03	/Styles.space.Icon.command.eweapons	space
pilot_imperial_navy_procedures_04	/Styles.space.Icon.command.bstrike2	space
pilot_imperial_navy_droid_01	/Styles.space.Icon.droid.droidEngineOverloadOne	space
pilot_imperial_navy_droid_02	/Styles.space.Icon.droid.droidWeaponOverloadTwo	space
pilot_imperial_navy_droid_03	/Styles.space.Icon.droid.droidWeaponEffeciencyThree	space
pilot_imperial_navy_droid_04	/Styles.space.Icon.droid.droidEngineEfficiencyFour	space
pilot_neutral_novice	/Styles.space.Icon.droid.droidMuteDroid	space
pilot_neutral_master	/Styles.space.Icon.command.iffScramble	space
pilot_neutral_starships_01	/Styles.space.Icon.command.ptrap1	space
pilot_neutral_starships_02	/Styles.space.Icon.command.ptrap1	space
pilot_neutral_starships_03	/Styles.space.Icon.command.ptrap1	space
pilot_neutral_starships_04	/Styles.space.Icon.command.ptrap1	space
pilot_neutral_weapons_01	/Styles.space.Icon.command.nblast	space
pilot_neutral_weapons_02	/Styles.space.Icon.command.nblast	space
pilot_neutral_weapons_03	/Styles.space.Icon.command.nblast	space
pilot_neutral_weapons_04	/Styles.space.Icon.command.nblast	space
pilot_neutral_procedures_01	/Styles.space.Icon.command.ethrust	space
pilot_neutral_procedures_02	/Styles.space.Icon.command.ethrust	space
pilot_neutral_procedures_03	/Styles.space.Icon.command.epulse1	space
pilot_neutral_procedures_04	/Styles.space.Icon.command.epulse2	space
pilot_neutral_droid_01	/Styles.space.Icon.droid.droidReactorOverloadOne	space
pilot_neutral_droid_02	/Styles.space.Icon.droid.droidWeapCapPowerupTwo	space
pilot_neutral_droid_03	/Styles.space.Icon.droid.droidWeapCapToShieldThree	space
pilot_neutral_droid_04	/Styles.space.Icon.droid.droidReactorOverloadFour	space
expertise_fs_general_enhanced_strength_1	/Styles.Icon.command.fs_general_enhanced_strength	
expertise_fs_general_enhanced_strength_2	/Styles.Icon.command.fs_general_enhanced_strength	
expertise_fs_general_enhanced_strength_3	/Styles.Icon.command.fs_general_enhanced_strength	
expertise_fs_general_enhanced_strength_4	/Styles.Icon.command.fs_general_enhanced_strength	
expertise_fs_general_enhanced_constitution_1	/Styles.Icon.command.fs_general_enhanced_constitution	
expertise_fs_general_enhanced_constitution_2	/Styles.Icon.command.fs_general_enhanced_constitution	
expertise_fs_general_enhanced_constitution_3	/Styles.Icon.command.fs_general_enhanced_constitution	
expertise_fs_general_enhanced_constitution_4	/Styles.Icon.command.fs_general_enhanced_constitution	
expertise_fs_general_enhanced_agility_1	/Styles.Icon.command.fs_general_enhanced_agility	
expertise_fs_general_enhanced_agility_2	/Styles.Icon.command.fs_general_enhanced_agility	
expertise_fs_general_enhanced_agility_3	/Styles.Icon.command.fs_general_enhanced_agility	
expertise_fs_general_enhanced_agility_4	/Styles.Icon.command.fs_general_enhanced_agility	
expertise_fs_general_enhanced_stamina_1	/Styles.Icon.command.fs_general_enhanced_stamina	
expertise_fs_general_enhanced_stamina_2	/Styles.Icon.command.fs_general_enhanced_stamina	
expertise_fs_general_enhanced_stamina_3	/Styles.Icon.command.fs_general_enhanced_stamina	
expertise_fs_general_enhanced_stamina_4	/Styles.Icon.command.fs_general_enhanced_stamina	
expertise_fs_general_crippling_accuracy_1	/Styles.Icon.command.fs_general_crippling_accuracy	
expertise_fs_general_crippling_accuracy_2	/Styles.Icon.command.fs_general_crippling_accuracy	
expertise_fs_general_crippling_accuracy_3	/Styles.Icon.command.fs_general_crippling_accuracy	
expertise_fs_general_crippling_accuracy_4	/Styles.Icon.command.fs_general_crippling_accuracy	
expertise_fs_general_improved_force_throw_1	/Styles.Icon.command.forceThrow	
expertise_fs_general_improved_force_throw_2	/Styles.Icon.command.forceThrow	
expertise_fs_general_alacrity_1	/Styles.Icon.command.fs_general_alacrity	
expertise_fs_general_alacrity_2	/Styles.Icon.command.fs_general_alacrity	
expertise_fs_general_alacrity_3	/Styles.Icon.command.fs_general_alacrity	
expertise_fs_general_alacrity_4	/Styles.Icon.command.fs_general_alacrity	
expertise_fs_general_improved_crippling_accuracy_1	/Styles.Icon.command.fs_general_improved_crippling_accuracy	
expertise_fs_general_improved_crippling_accuracy_2	/Styles.Icon.command.fs_general_improved_crippling_accuracy	
expertise_fs_general_improved_crippling_accuracy_3	/Styles.Icon.command.fs_general_improved_crippling_accuracy	
expertise_fs_general_exacting_strikes_1	/Styles.Icon.command.fs_general_exacting_strikes	
expertise_fs_general_exacting_strikes_2	/Styles.Icon.command.fs_general_exacting_strikes	
expertise_fs_general_exacting_strikes_3	/Styles.Icon.command.fs_general_exacting_strikes	
expertise_fs_general_exacting_strikes_4	/Styles.Icon.command.fs_general_exacting_strikes	
expertise_fs_general_force_cloak_1	/Styles.Icon.command.fs_buff_invis	
expertise_fs_general_heightened_speed_1	/Styles.Icon.command.fs_general_heightened_speed	
expertise_fs_general_heightened_speed_2	/Styles.Icon.command.fs_general_heightened_speed	
expertise_fs_general_heightened_speed_3	/Styles.Icon.command.fs_general_heightened_speed	
expertise_fs_general_heightened_speed_4	/Styles.Icon.command.fs_general_heightened_speed	
expertise_fs_general_stance_saber_block_1	/Styles.Icon.command.saberBlock	
expertise_fs_general_improved_saber_block_1	/Styles.Icon.command.fs_general_improved_saber_block	
expertise_fs_general_improved_saber_block_2	/Styles.Icon.command.fs_general_improved_saber_block	
expertise_fs_general_improved_saber_block_3	/Styles.Icon.command.fs_general_improved_saber_block	
expertise_fs_general_incisiveness_1	/Styles.Icon.command.fs_general_incisiveness	
expertise_fs_general_incisiveness_2	/Styles.Icon.command.fs_general_incisiveness	
expertise_fs_general_incisiveness_3	/Styles.Icon.command.fs_general_incisiveness	
expertise_fs_general_incisiveness_4	/Styles.Icon.command.fs_general_incisiveness	
expertise_fs_general_second_wind_1	/Styles.Icon.command.fs_general_second_wind	
expertise_fs_general_second_wind_2	/Styles.Icon.command.fs_general_second_wind	
expertise_fs_general_force_shockwave_1	/Styles.Icon.command.fs_dm_cc_crit	
expertise_fs_general_improved_force_shockwave_1	/Styles.Icon.command.fs_general_improved_force_shockwave	
expertise_fs_general_improved_force_shockwave_2	/Styles.Icon.command.fs_general_improved_force_shockwave	
expertise_fs_general_improved_force_shockwave_3	/Styles.Icon.command.fs_general_improved_force_shockwave	
expertise_fs_general_fidelity_1	/Styles.Icon.command.fs_general_fidelity	
expertise_fs_general_fidelity_2	/Styles.Icon.command.fs_general_fidelity	
expertise_fs_general_fidelity_3	/Styles.Icon.command.fs_general_fidelity	
expertise_fs_general_fidelity_4	/Styles.Icon.command.fs_general_fidelity	
expertise_fs_general_improved_force_cloak_1	/Styles.Icon.command.fs_general_improved_force_cloak	
expertise_fs_general_grace_in_motion_1	/Styles.Icon.command.fs_general_grace_in_motion	
expertise_fs_general_grace_in_motion_2	/Styles.Icon.command.fs_general_grace_in_motion	
expertise_fs_general_grace_in_motion_3	/Styles.Icon.command.fs_general_grace_in_motion	
expertise_fs_general_premonition_1	/Styles.Icon.command.fs_general_premonition	
expertise_fs_general_premonition_2	/Styles.Icon.command.fs_general_premonition	
expertise_fs_general_premonition_3	/Styles.Icon.command.fs_general_premonition	
expertise_fs_general_premonition_4	/Styles.Icon.command.fs_general_premonition	
expertise_fs_path_perceptive_sentinel_1	/Styles.Icon.command.fs_path_perceptive_sentinel	
expertise_fs_path_perceptive_sentinel_2	/Styles.Icon.command.fs_path_perceptive_sentinel	
expertise_fs_path_perceptive_sentinel_3	/Styles.Icon.command.fs_path_perceptive_sentinel	
expertise_fs_path_perceptive_sentinel_4	/Styles.Icon.command.fs_path_perceptive_sentinel	
expertise_fs_path_ruthless_precision_1	/Styles.Icon.command.fs_path_ruthless_precision	
expertise_fs_path_ruthless_precision_2	/Styles.Icon.command.fs_path_ruthless_precision	
expertise_fs_path_ruthless_precision_3	/Styles.Icon.command.fs_path_ruthless_precision	
expertise_fs_path_ruthless_precision_4	/Styles.Icon.command.fs_path_ruthless_precision	
expertise_fs_path_riposte_1	/Styles.Icon.command.fs_path_riposte	
expertise_fs_path_riposte_2	/Styles.Icon.command.fs_path_riposte	
expertise_fs_path_force_drain_1	/Styles.Icon.command.fs_path_force_drain	
expertise_fs_path_improved_force_drain_1	/Styles.Icon.command.fs_path_improved_force_drain	
expertise_fs_path_improved_force_drain_2	/Styles.Icon.command.fs_path_improved_force_drain	
expertise_fs_path_improved_force_drain_3	/Styles.Icon.command.fs_path_improved_force_drain	
expertise_fs_path_improved_force_drain_4	/Styles.Icon.command.fs_path_improved_force_drain	
expertise_fs_path_saber_reflect_1	/Styles.Icon.command.fs_path_saber_reflect	
expertise_fs_path_improved_saber_reflect_1	/Styles.Icon.command.fs_path_improved_saber_reflect	
expertise_fs_path_improved_saber_reflect_2	/Styles.Icon.command.fs_path_improved_saber_reflect	
expertise_fs_path_improved_saber_reflect_3	/Styles.Icon.command.fs_path_improved_saber_reflect	
expertise_fs_path_improved_saber_reflect_4	/Styles.Icon.command.fs_path_improved_saber_reflect	
expertise_fs_path_flurry	/Styles.Icon.command.fs_flurry	
expertise_fs_path_cautious_nature_1	/Styles.Icon.command.fs_path_cautious_nature	
expertise_fs_path_cautious_nature_2	/Styles.Icon.command.fs_path_cautious_nature	
expertise_fs_path_cautious_nature_3	/Styles.Icon.command.fs_path_cautious_nature	
expertise_fs_path_cautious_nature_4	/Styles.Icon.command.fs_path_cautious_nature	
expertise_fs_path_remorseless_nature_1	/Styles.Icon.command.fs_path_remorseless_nature	
expertise_fs_path_remorseless_nature_2	/Styles.Icon.command.fs_path_remorseless_nature	
expertise_fs_path_remorseless_nature_3	/Styles.Icon.command.fs_path_remorseless_nature	
expertise_fs_path_remorseless_nature_4	/Styles.Icon.command.fs_path_remorseless_nature	
expertise_fs_path_saber_shackle_1	/Styles.Icon.command.fs_path_practiced_fluidity	
expertise_fs_path_saber_shackle_2	/Styles.Icon.command.fs_path_practiced_fluidity	
expertise_fs_path_saber_shackle_3	/Styles.Icon.command.fs_path_practiced_fluidity	
expertise_fs_path_saber_shackle_4	/Styles.Icon.command.fs_path_practiced_fluidity	
expertise_fs_path_soothing_aura_1	/Styles.Icon.command.fs_path_soothing_aura	
expertise_fs_path_soothing_aura_2	/Styles.Icon.command.fs_path_soothing_aura	
expertise_fs_path_soothing_aura_3	/Styles.Icon.command.fs_path_soothing_aura	
expertise_fs_path_soothing_aura_4	/Styles.Icon.command.fs_path_soothing_aura	
expertise_fs_path_brutality_1	/Styles.Icon.command.fs_path_brutality	
expertise_fs_path_brutality_2	/Styles.Icon.command.fs_path_brutality	
expertise_fs_path_brutality_3	/Styles.Icon.command.fs_path_brutality	
expertise_fs_path_brutality_4	/Styles.Icon.command.fs_path_brutality	
expertise_fs_path_force_choke_1	/Styles.Icon.command.fs_dm_cc	
expertise_fs_path_reactive_response_1	/Styles.Icon.command.fs_path_reactive_response	
expertise_fs_path_reactive_response_2	/Styles.Icon.command.fs_path_reactive_response	
expertise_fs_path_forsake_fear_1	/Styles.Icon.command.fs_path_forsake_fear	
expertise_fs_path_cloud_minds_1	/Styles.Icon.command.fs_mind_trick	
expertise_fs_path_dark_lightning_1	/Styles.Icon.command.fs_ae_dm_cc	
expertise_fs_path_tempt_hatred_1	/Styles.Icon.command.fs_path_tempt_hatred	
expertise_fs_path_tempt_hatred_2	/Styles.Icon.command.fs_path_tempt_hatred	
expertise_fs_path_improved_force_choke_1	/Styles.Icon.command.fs_path_improved_force_choke	
expertise_fs_path_improved_force_choke_2	/Styles.Icon.command.fs_path_improved_force_choke	
expertise_fs_path_force_clarity_1	/Styles.Icon.command.fs_path_force_clarity	
expertise_fs_path_hermetic_touch_1	/Styles.Icon.command.fs_path_hermetic_touch	
expertise_fs_path_expansive_trickery_1	/Styles.Icon.command.fs_mind_trick	
expertise_fs_path_expansive_trickery_2	/Styles.Icon.command.fs_mind_trick	
expertise_fs_path_expansive_trickery_3	/Styles.Icon.command.fs_mind_trick	
expertise_fs_path_wracking_energy_1	/Styles.Icon.command.fs_ae_dm_cc	
expertise_fs_path_wracking_energy_2	/Styles.Icon.command.fs_ae_dm_cc	
expertise_fs_path_wracking_energy_3	/Styles.Icon.command.fs_ae_dm_cc	
expertise_fs_path_wracking_energy_4	/Styles.Icon.command.fs_ae_dm_cc	
expertise_fs_path_anticipate_aggression_1	/Styles.Icon.command.fs_path_anticipate_aggression	
expertise_fs_path_anticipate_aggression_2	/Styles.Icon.command.fs_path_anticipate_aggression	
expertise_fs_path_lasting_aura_1	/Styles.Icon.command.fs_path_lasting_aura	
expertise_fs_path_lasting_aura_2	/Styles.Icon.command.fs_path_lasting_aura	
expertise_fs_path_lethargy_1	/Styles.Icon.command.fs_mind_trick	
expertise_fs_path_lethargy_2	/Styles.Icon.command.fs_mind_trick	
expertise_fs_path_lethargy_3	/Styles.Icon.command.fs_mind_trick	
expertise_fs_path_lethargy_4	/Styles.Icon.command.fs_mind_trick	
expertise_fs_path_maelstrom_1	/Styles.Icon.command.fs_path_maelstrom	
expertise_fs_path_strangulation_1	/Styles.Icon.command.fs_path_improved_force_choke	
expertise_fs_path_strangulation_2	/Styles.Icon.command.fs_path_improved_force_choke	
expertise_bh_ass_act_1	/Styles.Icon.command.bh_dm	
expertise_bh_ass_act_2	/Styles.Icon.command.bh_dm	
expertise_bh_ass_act_3	/Styles.Icon.command.bh_dm	
expertise_bh_ass_act_4	/Styles.Icon.command.bh_dm	
expertise_bh_ass_dam_1	/Styles.Icon.command.bh_dm	
expertise_bh_ass_dam_2	/Styles.Icon.command.bh_dm	
expertise_bh_ass_dam_3	/Styles.Icon.command.bh_dm	
expertise_bh_ass_cool_1	/Styles.Icon.command.bh_dm	
expertise_bh_ass_cool_2	/Styles.Icon.command.bh_dm	
expertise_bh_innate_1	/Styles.Icon.command.bh_innate_assault	
expertise_bh_return_fire_1	/Styles.Icon.command.bh_return_fire_command	
expertise_bh_taunt_1	/Styles.Icon.command.bh_taunt	
expertise_bh_fumble_1	/Styles.Icon.command.bh_fumble	
expertise_bh_stun_1	/Styles.Icon.command.bh_stun	
expertise_bh_prescience	/Styles.Icon.command.bh_prescience	
expertise_bh_absorbtion_1	/Styles.Icon.command.bh_absorption	
expertise_bh_absorbtion_2	/Styles.Icon.command.bh_absorption	
expertise_bh_absorbtion_3	/Styles.Icon.command.bh_absorption	
expertise_bh_absorbtion_4	/Styles.Icon.command.bh_absorption	
expertise_bh_deflection_1	/Styles.Icon.command.bh_deflection	
expertise_bh_deflection_2	/Styles.Icon.command.bh_deflection	
expertise_bh_deflection_3	/Styles.Icon.command.bh_deflection	
expertise_bh_deflection_4	/Styles.Icon.command.bh_deflection	
expertise_bh_shields_1	/Styles.Icon.command.bh_shields	
expertise_bh_amb_act_1	/Styles.Icon.command.bh_dm_crit	
expertise_bh_amb_act_2	/Styles.Icon.command.bh_dm_crit	
expertise_bh_amb_act_3	/Styles.Icon.command.bh_dm_crit	
expertise_bh_amb_act_4	/Styles.Icon.command.bh_dm_crit	
expertise_bh_amb_dam_1	/Styles.Icon.command.bh_dm_crit	
expertise_bh_amb_dam_2	/Styles.Icon.command.bh_dm_crit	
expertise_bh_amb_dam_3	/Styles.Icon.command.bh_dm_crit	
expertise_bh_amb_cool_1	/Styles.Icon.command.bh_dm_crit	
expertise_bh_amb_cool_2	/Styles.Icon.command.bh_dm_crit	
expertise_bh_surprise_1	/Styles.Icon.command.co_path_riddle_armor	
expertise_bh_amb_dam_cool	/Styles.Icon.command.co_path_armor_splash	
expertise_bh_man_crit_1	/Styles.Icon.command.bh_man_crits	
expertise_bh_man_crit_2	/Styles.Icon.command.bh_man_crits	
expertise_bh_man_crit_3	/Styles.Icon.command.bh_man_crits	
expertise_bh_man_crit_4	/Styles.Icon.command.bh_man_crits	
expertise_bh_trap_dam_1	/Styles.Icon.command.bh_dm_cc	
expertise_bh_trap_dam_2	/Styles.Icon.command.bh_dm_cc	
expertise_bh_trap_dam_3	/Styles.Icon.command.bh_dm_cc	
expertise_bh_trap_dam_4	/Styles.Icon.command.bh_dm_cc	
expertise_bh_trap_rng_1	/Styles.Icon.command.bh_del_cc	
expertise_bh_trap_rng_2	/Styles.Icon.command.bh_del_cc	
expertise_bh_trap_duration_1	/Styles.Icon.command.bh_dm_cc	
expertise_bh_trap_duration_2	/Styles.Icon.command.bh_dm_cc	
expertise_bh_trap_duration_3	/Styles.Icon.command.bh_dm_cc	
expertise_bh_intimidate_1	/Styles.Icon.command.bh_intimidate	
expertise_bh_dread_strike_1	/Styles.Icon.command.bh_dread_strike	
expertise_bh_stamina_1	/Styles.Icon.command.bh_stamina	
expertise_bh_stamina_2	/Styles.Icon.command.bh_stamina	
expertise_bh_stamina_3	/Styles.Icon.command.bh_stamina	
expertise_bh_stamina_4	/Styles.Icon.command.bh_stamina	
expertise_bh_precision_1	/Styles.Icon.command.bh_precision	
expertise_bh_precision_2	/Styles.Icon.command.bh_precision	
expertise_bh_precision_3	/Styles.Icon.command.bh_precision	
expertise_bh_precision_4	/Styles.Icon.command.bh_precision	
expertise_bh_agility_1	/Styles.Icon.command.fs_general_enhanced_agility	
expertise_bh_agility_2	/Styles.Icon.command.fs_general_enhanced_agility	
expertise_bh_agility_3	/Styles.Icon.command.fs_general_enhanced_agility	
expertise_bh_agility_4	/Styles.Icon.command.fs_general_enhanced_agility	
expertise_bh_constitution_1	/Styles.Icon.command.fs_general_enhanced_constitution	
expertise_bh_constitution_2	/Styles.Icon.command.fs_general_enhanced_constitution	
expertise_bh_constitution_3	/Styles.Icon.command.fs_general_enhanced_constitution	
expertise_bh_constitution_4	/Styles.Icon.command.fs_general_enhanced_constitution	
expertise_bh_carbine_act_1	/Styles.Icon.command.bh_carbine	
expertise_bh_carbine_act_2	/Styles.Icon.command.bh_carbine	
expertise_bh_carbine_act_3	/Styles.Icon.command.bh_carbine	
expertise_bh_carbine_act_4	/Styles.Icon.command.bh_carbine	
expertise_bh_carbine_dam_1	/Styles.Icon.command.bh_carbine	
expertise_bh_carbine_dam_2	/Styles.Icon.command.bh_carbine	
expertise_bh_carbine_crit_1	/Styles.Icon.command.bh_carbine_crit	
expertise_bh_relentless_1	/Styles.Icon.command.bh_relentless	
expertise_bh_rifle_act_1	/Styles.Icon.command.bh_rifle	
expertise_bh_rifle_act_2	/Styles.Icon.command.bh_rifle	
expertise_bh_rifle_act_3	/Styles.Icon.command.bh_rifle	
expertise_bh_rifle_act_4	/Styles.Icon.command.bh_rifle	
expertise_bh_rifle_dam_1	/Styles.Icon.command.bh_rifle	
expertise_bh_rifle_dam_2	/Styles.Icon.command.bh_rifle	
expertise_bh_sniper_1	/Styles.Icon.command.bh_sniper	
expertise_bh_cover_1	/Styles.Icon.command.bh_cover	
expertise_bh_armor_kin_1	/Styles.Icon.command.bh_armor_kinetic	
expertise_bh_armor_kin_2	/Styles.Icon.command.bh_armor_kinetic	
expertise_bh_armor_kin_3	/Styles.Icon.command.bh_armor_kinetic	
expertise_bh_armor_kin_4	/Styles.Icon.command.bh_armor_kinetic	
expertise_bh_armor_mgb_1	/Styles.Icon.command.bh_armor_mgb	
expertise_bh_armor_mgb_2	/Styles.Icon.command.bh_armor_mgb	
expertise_bh_armor_mgb_3	/Styles.Icon.command.bh_armor_mgb	
expertise_bh_armor_sprint_1	/Styles.Icon.command.bh_armor_sprint	
expertise_bh_armor_eng_1	/Styles.Icon.command.bh_armor_energy	
expertise_bh_armor_eng_2	/Styles.Icon.command.bh_armor_energy	
expertise_bh_armor_eng_3	/Styles.Icon.command.bh_armor_energy	
expertise_bh_armor_eng_4	/Styles.Icon.command.bh_armor_energy	
expertise_bh_armor_rgb_1	/Styles.Icon.command.bh_armor_rgb	
expertise_bh_armor_rgb_2	/Styles.Icon.command.bh_armor_rgb	
expertise_bh_armor_rgb_3	/Styles.Icon.command.bh_armor_rgb	
expertise_bh_armor_duelist_1	/Styles.Icon.command.bh_armor_duelist	
expertise_sm_general_enhanced_precision_1	/Styles.Icon.command.sm_general_enhanced_precision	
expertise_sm_general_enhanced_precision_2	/Styles.Icon.command.sm_general_enhanced_precision	
expertise_sm_general_hidden_padding_1	/Styles.Icon.command.sm_general_hidden_padding	
expertise_sm_general_hidden_padding_2	/Styles.Icon.command.sm_general_hidden_padding	
expertise_sm_general_gun_oil_1	/Styles.Icon.command.sm_general_gun_oil	
expertise_sm_general_elbow_grease_1	/Styles.Icon.command.sm_general_elbow_grease	
expertise_sm_general_enhanced_luck_1	/Styles.Icon.command.sm_general_enhanced_luck	
expertise_sm_general_enhanced_luck_2	/Styles.Icon.command.sm_general_enhanced_luck	
expertise_sm_general_spot_a_sucker_1	/Styles.Icon.command.sm_general_spot_a_sucker	
expertise_sm_general_hair_trigger_1	/Styles.Icon.command.sm_general_hair_trigger	
expertise_sm_general_hair_trigger_2	/Styles.Icon.command.sm_general_hair_trigger	
expertise_sm_general_hair_trigger_3	/Styles.Icon.command.sm_general_hair_trigger	
expertise_sm_general_hair_trigger_4	/Styles.Icon.command.sm_general_hair_trigger	
expertise_sm_general_switcheroo_1	/Styles.Icon.command.sm_general_switcheroo	
expertise_sm_general_switcheroo_2	/Styles.Icon.command.sm_general_switcheroo	
expertise_sm_general_switcheroo_3	/Styles.Icon.command.sm_general_switcheroo	
expertise_sm_general_switcheroo_4	/Styles.Icon.command.sm_general_switcheroo	
expertise_sm_general_off_the_cuff_1	/Styles.Icon.command.sm_general_off_the_cuff	
expertise_sm_general_meager_fortune_1	/Styles.Icon.command.sm_general_meager_fortune	
expertise_sm_general_meager_fortune_2	/Styles.Icon.command.sm_general_meager_fortune	
expertise_sm_general_lined_pockets_1	/Styles.Icon.command.sm_general_lined_pockets	
expertise_sm_general_lined_pockets_2	/Styles.Icon.command.sm_general_lined_pockets	
expertise_sm_general_precise_bead_1	/Styles.Icon.command.sm_general_precise_bead	
expertise_sm_general_precise_bead_2	/Styles.Icon.command.sm_general_precise_bead	
expertise_sm_general_precise_bead_3	/Styles.Icon.command.sm_general_precise_bead	
expertise_sm_general_precise_bead_4	/Styles.Icon.command.sm_general_precise_bead	
expertise_sm_general_head_crack_1	/Styles.Icon.command.sm_general_head_crack	
expertise_sm_general_head_crack_2	/Styles.Icon.command.sm_general_head_crack	
expertise_sm_general_head_crack_3	/Styles.Icon.command.sm_general_head_crack	
expertise_sm_general_head_crack_4	/Styles.Icon.command.sm_general_head_crack	
expertise_sm_general_double_deal_1	/Styles.Icon.command.sm_general_double_deal	
expertise_sm_general_double_deal_2	/Styles.Icon.command.sm_general_double_deal	
expertise_sm_general_wretched_fate_1	/Styles.Icon.command.sm_general_wretched_fate	
expertise_sm_general_wretched_fate_2	/Styles.Icon.command.sm_general_wretched_fate	
expertise_sm_general_hammer_fanning_1	/Styles.Icon.command.sm_general_hammer_fanning	
expertise_sm_general_hammer_fanning_2	/Styles.Icon.command.sm_general_hammer_fanning	
expertise_sm_general_hammer_fanning_3	/Styles.Icon.command.sm_general_hammer_fanning	
expertise_sm_general_hammer_fanning_4	/Styles.Icon.command.sm_general_hammer_fanning	
expertise_sm_general_one_two_pummel_1	/Styles.Icon.command.sm_general_one_two_pummel	
expertise_sm_general_one_two_pummel_2	/Styles.Icon.command.sm_general_one_two_pummel	
expertise_sm_general_one_two_pummel_3	/Styles.Icon.command.sm_general_one_two_pummel	
expertise_sm_general_one_two_pummel_4	/Styles.Icon.command.sm_general_one_two_pummel	
expertise_sm_general_end_of_the_line_1	/Styles.Icon.command.sm_general_end_of_the_line	
expertise_sm_general_poor_prospect_1	/Styles.Icon.command.sm_general_poor_prospect	
expertise_sm_general_poor_prospect_2	/Styles.Icon.command.sm_general_poor_prospect	
expertise_sm_general_idiot_proof_plan_1	/Styles.Icon.command.sm_general_idiot_proof_plan	
expertise_sm_general_idiot_proof_plan_2	/Styles.Icon.command.sm_general_idiot_proof_plan	
expertise_sm_general_break_the_deal_1	/Styles.Icon.command.sm_general_break_the_deal	
expertise_sm_general_bad_odds_1	/Styles.Icon.command.sm_general_bad_odds	
expertise_sm_general_narrow_escape_1	/Styles.Icon.command.sm_general_narrow_escape	
expertise_sm_path_sly_lie_1	/Styles.Icon.command.sm_path_sly_lie	
expertise_sm_path_fast_talk_1	/Styles.Icon.command.sm_path_fast_talk	
expertise_sm_path_easy_money_1	/Styles.Icon.command.sm_path_easy_money	
expertise_sm_path_easy_money_2	/Styles.Icon.command.sm_path_easy_money	
expertise_sm_path_ploy_1	/Styles.Icon.command.sm_path_ploy	
expertise_sm_path_ploy_2	/Styles.Icon.command.sm_path_ploy	
expertise_sm_path_healthy_profits_1	/Styles.Icon.command.sm_path_healthy_profits	
expertise_sm_path_half_truth_1	/Styles.Icon.command.sm_path_half_truth	
expertise_sm_path_half_truth_2	/Styles.Icon.command.sm_path_half_truth	
expertise_sm_path_fake_id_1	/Styles.Icon.command.sm_path_fake_id	
expertise_sm_path_impossible_odds_1	/Styles.Icon.command.sm_impossible_odds	
expertise_sm_path_feeling_lucky_1	/Styles.Icon.command.sm_path_feeling_lucky	
expertise_sm_path_feeling_lucky_2	/Styles.Icon.command.sm_path_feeling_lucky	
expertise_sm_path_feeling_lucky_3	/Styles.Icon.command.sm_path_feeling_lucky	
expertise_sm_path_feeling_lucky_4	/Styles.Icon.command.sm_path_feeling_lucky	
expertise_sm_path_scandal_1	/Styles.Icon.command.sm_path_scandal	
expertise_sm_path_scandal_2	/Styles.Icon.command.sm_path_scandal	
expertise_sm_path_scandal_3	/Styles.Icon.command.sm_path_scandal	
expertise_sm_path_scandal_4	/Styles.Icon.command.sm_path_scandal	
expertise_sm_path_innocent_cargo_1	/Styles.Icon.command.sm_path_innocent_cargo	
expertise_sm_path_innocent_cargo_2	/Styles.Icon.command.sm_path_innocent_cargo	
expertise_sm_path_underworld_boss_1	/Styles.Icon.command.sm_path_underworld_boss	
expertise_sm_path_lucky_break_1	/Styles.Icon.command.sm_path_lucky_break	
expertise_sm_path_lucky_break_2	/Styles.Icon.command.sm_path_lucky_break	
expertise_sm_path_lucky_break_3	/Styles.Icon.command.sm_path_lucky_break	
expertise_sm_path_lucky_break_4	/Styles.Icon.command.sm_path_lucky_break	
expertise_sm_path_smooth_move_1	/Styles.Icon.command.sm_path_smooth_move	
expertise_sm_path_smooth_move_2	/Styles.Icon.command.sm_path_smooth_move	
expertise_sm_path_smooth_move_3	/Styles.Icon.command.sm_path_smooth_move	
expertise_sm_path_smooth_move_4	/Styles.Icon.command.sm_path_smooth_move	
expertise_sm_path_off_the_books_1	/Styles.Icon.command.sm_path_off_the_books	
expertise_sm_path_inside_information_1	/Styles.Icon.command.sm_path_inside_information	
expertise_sm_path_long_odds_1	/Styles.Icon.command.sm_path_long_odds	
expertise_sm_path_card_up_your_sleeve_1	/Styles.Icon.command.sm_path_card_up_your_sleeve	
expertise_sm_path_card_up_your_sleeve_2	/Styles.Icon.command.sm_path_card_up_your_sleeve	
expertise_sm_path_card_up_your_sleeve_3	/Styles.Icon.command.sm_path_card_up_your_sleeve	
expertise_sm_path_card_up_your_sleeve_4	/Styles.Icon.command.sm_path_card_up_your_sleeve	
expertise_sm_path_false_hope_1	/Styles.Icon.command.sm_path_false_hope	
expertise_sm_path_under_the_counter_1	/Styles.Icon.command.sm_path_under_the_counter	
expertise_sm_path_under_the_counter_2	/Styles.Icon.command.sm_path_under_the_counter	
expertise_sm_path_quick_fix_1	/Styles.Icon.command.sm_path_quick_fix	
expertise_sm_path_quick_fix_2	/Styles.Icon.command.sm_path_quick_fix	
expertise_sm_path_quick_fix_3	/Styles.Icon.command.sm_path_quick_fix	
expertise_sm_path_quick_fix_4	/Styles.Icon.command.sm_path_quick_fix	
expertise_sm_path_fake_goods_1	/Styles.Icon.command.sm_path_fake_goods	
expertise_sm_path_fake_goods_2	/Styles.Icon.command.sm_path_fake_goods	
expertise_sm_path_best_deal_ever_1	/Styles.Icon.command.sm_path_best_deal_ever	
expertise_sm_path_best_deal_ever_2	/Styles.Icon.command.sm_path_best_deal_ever	
expertise_sm_path_blindside_1	/Styles.Icon.command.sm_path_blindside	
expertise_sm_path_blindside_2	/Styles.Icon.command.sm_path_blindside	
expertise_sm_path_skullduggery_1	/Styles.Icon.command.sm_skullduggery	
expertise_sm_path_eat_dirt_1	/Styles.Icon.command.sm_path_eat_dirt	
expertise_sm_path_eat_dirt_2	/Styles.Icon.command.sm_path_eat_dirt	
expertise_sm_path_sleight_of_hand_1	/Styles.Icon.command.sm_path_sleight_of_hand	
expertise_sm_path_sleight_of_hand_2	/Styles.Icon.command.sm_path_sleight_of_hand	
expertise_sm_path_impossible_odds_1	/Styles.Icon.command.sm_impossible_odds	
expertise_sm_path_loaded_chance_dice_1	/Styles.Icon.command.sm_path_loaded_chance_dice	
expertise_sm_path_loaded_chance_dice_2	/Styles.Icon.command.sm_path_loaded_chance_dice	
expertise_sm_path_flying_tackle_1	/Styles.Icon.command.sm_path_flying_tackle	
expertise_sm_path_flying_tackle_2	/Styles.Icon.command.sm_path_flying_tackle	
expertise_sm_path_pistol_whip_1	/Styles.Icon.command.sm_pistol_whip	
expertise_sm_path_beat_down_1	/Styles.Icon.command.sm_path_beat_down	
expertise_sm_path_beat_down_2	/Styles.Icon.command.sm_path_beat_down	
expertise_sm_path_blaster_at_your_side_1	/Styles.Icon.command.sm_path_blaster_at_your_side	
expertise_sm_path_blaster_at_your_side_2	/Styles.Icon.command.sm_path_blaster_at_your_side	
expertise_sm_path_shoot_first_1	/Styles.Icon.command.sm_shoot_first	
expertise_sm_general_nerf_herder_1	/Styles.Icon.command.sm_nerf_herder	
expertise_of_group_buff_duration_1	/Styles.Icon.command.of_group_buff_duration	
expertise_of_group_buff_duration_2	/Styles.Icon.command.of_group_buff_duration	
expertise_of_aggro_channel_1	/Styles.Icon.command.of_aggro_channel	
expertise_of_aggro_channel_2	/Styles.Icon.command.of_aggro_channel	
expertise_of_aggro_channel_3	/Styles.Icon.command.of_aggro_channel	
expertise_of_group_buff_act_1	/Styles.Icon.command.of_group_buff_duration	
expertise_of_group_buff_act_2	/Styles.Icon.command.of_group_buff_duration	
expertise_of_group_buff_act_3	/Styles.Icon.command.of_group_buff_duration	
expertise_of_advanced_tactics_1	/Styles.Icon.command.of_buff_def	
expertise_of_focus_fire_1	/Styles.Icon.command.of_focus_fire	
expertise_of_inspiration_1	/Styles.Icon.command.of_inspiration	
expertise_of_scatter_1	/Styles.Icon.command.of_scatter	
expertise_of_charge_1	/Styles.Icon.command.of_charge	
expertise_of_last_words_1	/Styles.Icon.command.of_last_words	
expertise_of_sup_cool_1	/Styles.Icon.command.of_drop	
expertise_of_sup_cool_2	/Styles.Icon.command.of_drop	
expertise_of_sup_cool_3	/Styles.Icon.command.of_drop	
expertise_of_sup_cool_4	/Styles.Icon.command.of_drop	
expertise_of_medical_sup_1	/Styles.Icon.command.of_medical_sup	
expertise_of_tactical_sup_1	/Styles.Icon.command.of_tactical_sup	
expertise_of_reinforcements_1	/Styles.Icon.command.of_reinforcements	
expertise_of_aoe_act_1	/Styles.Icon.command.of_aoe_expertise	
expertise_of_aoe_act_2	/Styles.Icon.command.of_aoe_expertise	
expertise_of_aoe_act_3	/Styles.Icon.command.of_aoe_expertise	
expertise_of_aoe_act_4	/Styles.Icon.command.of_aoe_expertise	
expertise_of_aoe_crit_1	/Styles.Icon.command.of_aoe_expertise	
expertise_of_aoe_crit_2	/Styles.Icon.command.of_aoe_expertise	
expertise_of_aoe_crit_3	/Styles.Icon.command.of_aoe_expertise	
expertise_of_aoe_dam_1	/Styles.Icon.command.of_aoe_expertise	
expertise_of_aoe_dam_2	/Styles.Icon.command.of_aoe_expertise	
expertise_of_firepower_1	/Styles.Icon.command.of_firepower	
expertise_of_firepower_cool_1	/Styles.Icon.command.of_firepower	
expertise_of_firepower_cool_2	/Styles.Icon.command.of_firepower	
expertise_of_firepower_cool_3	/Styles.Icon.command.of_firepower	
expertise_of_sure_act_1	/Styles.Icon.command.of_dm	
expertise_of_sure_act_2	/Styles.Icon.command.of_dm	
expertise_of_sure_act_3	/Styles.Icon.command.of_dm	
expertise_of_sure_act_4	/Styles.Icon.command.of_dm	
expertise_of_sure_dam_1	/Styles.Icon.command.of_dm	
expertise_of_sure_dam_2	/Styles.Icon.command.of_dm	
expertise_of_sure_dam_3	/Styles.Icon.command.of_dm	
expertise_of_sure_dam_4	/Styles.Icon.command.of_dm	
expertise_of_paint_act_1	/Styles.Icon.command.of_deb_def	
expertise_of_paint_act_2	/Styles.Icon.command.of_deb_def	
expertise_of_paint_act_3	/Styles.Icon.command.of_deb_def	
expertise_of_paint_dam_1	/Styles.Icon.command.of_deb_def	
expertise_of_paint_dam_2	/Styles.Icon.command.of_deb_def	
expertise_of_paint_debuff_1	/Styles.Icon.command.of_paint_debuff	
expertise_of_advanced_paint_1	/Styles.Icon.command.of_deb_def	
expertise_of_paint_expose_1	/Styles.Icon.command.of_paint_expose	
expertise_of_strength_1	/Styles.Icon.command.fs_general_enhanced_strength	
expertise_of_strength_2	/Styles.Icon.command.fs_general_enhanced_strength	
expertise_of_strength_3	/Styles.Icon.command.fs_general_enhanced_strength	
expertise_of_strength_4	/Styles.Icon.command.fs_general_enhanced_strength	
expertise_of_precision_1	/Styles.Icon.command.bh_precision	
expertise_of_precision_2	/Styles.Icon.command.bh_precision	
expertise_of_precision_3	/Styles.Icon.command.bh_precision	
expertise_of_precision_4	/Styles.Icon.command.bh_precision	
expertise_of_constitution_1	/Styles.Icon.command.fs_general_enhanced_constitution	
expertise_of_constitution_2	/Styles.Icon.command.fs_general_enhanced_constitution	
expertise_of_constitution_3	/Styles.Icon.command.fs_general_enhanced_constitution	
expertise_of_constitution_4	/Styles.Icon.command.fs_general_enhanced_constitution	
expertise_of_stamina_1	/Styles.Icon.command.bh_stamina	
expertise_of_stamina_2	/Styles.Icon.command.bh_stamina	
expertise_of_stamina_3	/Styles.Icon.command.bh_stamina	
expertise_of_stamina_4	/Styles.Icon.command.bh_stamina	
expertise_of_1h_dam_1	/Styles.Icon.command.of_1h_expertise	
expertise_of_1h_dam_2	/Styles.Icon.command.of_1h_expertise	
expertise_of_1h_dam_3	/Styles.Icon.command.of_1h_expertise	
expertise_of_1h_dam_4	/Styles.Icon.command.of_1h_expertise	
expertise_of_1h_crit_1	/Styles.Icon.command.of_1h_expertise	
expertise_of_1h_crit_2	/Styles.Icon.command.of_1h_expertise	
expertise_of_decapitate_1	/Styles.Icon.command.of_decapitate	
expertise_of_leg_strike_1	/Styles.Icon.command.of_leg_strike	
expertise_of_vortex_1	/Styles.Icon.command.of_vortex	
expertise_of_pistol_act_1	/Styles.Icon.command.of_pistol_expertise	
expertise_of_pistol_act_2	/Styles.Icon.command.of_pistol_expertise	
expertise_of_pistol_act_3	/Styles.Icon.command.of_pistol_expertise	
expertise_of_pistol_act_4	/Styles.Icon.command.of_pistol_expertise	
expertise_of_pistol_dam_1	/Styles.Icon.command.of_pistol_expertise	
expertise_of_pistol_dam_2	/Styles.Icon.command.of_pistol_expertise	
expertise_of_pistol_dam_3	/Styles.Icon.command.of_pistol_expertise	
expertise_of_pistol_dam_4	/Styles.Icon.command.of_pistol_expertise	
expertise_of_pistol_crit_1	/Styles.Icon.command.of_pistol_expertise	
expertise_of_pistol_crit_2	/Styles.Icon.command.of_pistol_expertise	
expertise_of_drillmaster_1	/Styles.Icon.command.of_drillmaster	
expertise_of_armor_eng_1	/Styles.Icon.command.bh_armor_energy	
expertise_of_armor_eng_2	/Styles.Icon.command.bh_armor_energy	
expertise_of_stimulator_1	/Styles.Icon.command.of_stimulator	
expertise_of_heal_dam_1	/Styles.Icon.command.of_sh	
expertise_of_heal_dam_2	/Styles.Icon.command.of_sh	
expertise_of_armor_kin_1	/Styles.Icon.command.bh_armor_kinetic	
expertise_of_armor_kin_2	/Styles.Icon.command.bh_armor_kinetic	
expertise_of_emergency_shield	/Styles.Icon.command.of_emergency_shield	
expertise_of_purge_1	/Styles.Icon.command.of_purge	
expertise_of_heal_cool_1	/Styles.Icon.command.of_sh	
expertise_of_heal_cool_2	/Styles.Icon.command.of_sh	
expertise_co_remote_detonator_1	/Styles.Icon.command.co_path_remote_detonator	
expertise_co_suppressing_fire_1	/Styles.Icon.command.co_path_suppressing_fire	
expertise_co_powered_armor_1	/Styles.Icon.command.co_path_powered_armor	
expertise_co_powered_armor_2	/Styles.Icon.command.co_path_powered_armor	
expertise_co_powered_armor_3	/Styles.Icon.command.co_path_powered_armor	
expertise_co_powered_armor_4	/Styles.Icon.command.co_path_powered_armor	
expertise_co_it_burns_1	/Styles.Icon.command.co_path_it_burns	
expertise_co_it_burns_2	/Styles.Icon.command.co_path_it_burns	
expertise_co_it_burns_3	/Styles.Icon.command.co_path_it_burns	
expertise_co_it_burns_4	/Styles.Icon.command.co_path_it_burns	
expertise_co_flashbang_1	/Styles.Icon.command.co_path_flashbang	
expertise_co_flashbang_2	/Styles.Icon.command.co_path_flashbang	
expertise_co_suppression_efficiency_1	/Styles.Icon.command.co_path_suppression_efficiency	
expertise_co_suppression_efficiency_2	/Styles.Icon.command.co_path_suppression_efficiency	
expertise_co_suppression_efficiency_3	/Styles.Icon.command.co_path_suppression_efficiency	
expertise_co_suppression_efficiency_4	/Styles.Icon.command.co_path_suppression_efficiency	
expertise_co_pinpoint_shielding_1	/Styles.Icon.command.co_path_pinpoint_shielding	
expertise_co_pinpoint_shielding_2	/Styles.Icon.command.co_path_pinpoint_shielding	
expertise_co_pinpoint_shielding_3	/Styles.Icon.command.co_path_pinpoint_shielding	
expertise_co_pinpoint_shielding_4	/Styles.Icon.command.co_path_pinpoint_shielding	
expertise_co_blow_em_away_1	/Styles.Icon.command.co_path_blow_em_away	
expertise_co_cluster_bomb	/Styles.Icon.command.co_path_improved_explosives	
expertise_co_timer_reset_1	/Styles.Icon.command.co_path_timer_reset	
expertise_co_timer_reset_2	/Styles.Icon.command.co_path_timer_reset	
expertise_co_riddle_armor_1	/Styles.Icon.command.co_path_riddle_armor	
expertise_co_deflective_armor_1	/Styles.Icon.command.co_path_deflective_armor	
expertise_co_deflective_armor_2	/Styles.Icon.command.co_path_deflective_armor	
expertise_co_deflective_armor_3	/Styles.Icon.command.co_path_deflective_armor	
expertise_co_deflective_armor_4	/Styles.Icon.command.co_path_deflective_armor	
expertise_co_killing_spree	/Styles.Icon.command.co_path_killing_grimace	
expertise_co_killing_grimace_1	/Styles.Icon.command.co_path_killing_grimace	
expertise_co_angled_shrapnel_1	/Styles.Icon.command.co_path_angled_shrapnel	
expertise_co_angled_shrapnel_2	/Styles.Icon.command.co_path_angled_shrapnel	
expertise_co_armor_cracker_1	/Styles.Icon.command.co_path_armor_cracker	
expertise_co_armor_cracker_2	/Styles.Icon.command.co_path_armor_cracker	
expertise_co_armor_cracker_3	/Styles.Icon.command.co_path_armor_cracker	
expertise_co_armor_cracker_4	/Styles.Icon.command.co_path_armor_cracker	
expertise_co_stim_armor_1	/Styles.Icon.command.co_path_stim_armor	
expertise_co_imp_riddle_armor_1	/Styles.Icon.command.co_path_armor_splash	
expertise_co_imp_riddle_armor_2	/Styles.Icon.command.co_path_armor_splash	
expertise_co_improved_explosives_1	/Styles.Icon.command.co_path_improved_explosives	
expertise_co_improved_explosives_2	/Styles.Icon.command.co_path_improved_explosives	
expertise_co_improved_explosives_3	/Styles.Icon.command.co_path_improved_explosives	
expertise_co_improved_explosives_4	/Styles.Icon.command.co_path_improved_explosives	
expertise_co_mirror_armor_1	/Styles.Icon.command.co_path_mirror_armor	
expertise_co_diagnostic_armor_1	/Styles.Icon.command.co_path_diagnostic_armor	
expertise_co_youll_regret_that_1	/Styles.Icon.command.co_path_youll_regret_that	
expertise_co_youll_regret_that_2	/Styles.Icon.command.co_path_youll_regret_that	
expertise_co_general_enhanced_luck_1	/Styles.Icon.command.sm_general_enhanced_luck	
expertise_co_general_enhanced_luck_2	/Styles.Icon.command.sm_general_enhanced_luck	
expertise_co_enhanced_precision_1	/Styles.Icon.command.co_general_enhanced_precision	
expertise_co_enhanced_precision_2	/Styles.Icon.command.co_general_enhanced_precision	
expertise_co_enhanced_constitution_1	/Styles.Icon.command.co_general_enhanced_constitution	
expertise_co_enhanced_constitution_2	/Styles.Icon.command.co_general_enhanced_constitution	
expertise_co_enhanced_stamina_1	/Styles.Icon.command.co_general_enhanced_stamina	
expertise_co_enhanced_stamina_2	/Styles.Icon.command.co_general_enhanced_stamina	
expertise_co_position_secured_1	/Styles.Icon.command.co_general_position_secured	
expertise_co_imp_position_secured_1	/Styles.Icon.command.co_imp_position_secured	
expertise_co_imp_position_secured_2	/Styles.Icon.command.co_imp_position_secured	
expertise_co_imp_position_secured_3	/Styles.Icon.command.co_imp_position_secured	
expertise_co_hose_down_1	/Styles.Icon.command.co_general_hose_down	
expertise_co_hose_down_2	/Styles.Icon.command.co_general_hose_down	
expertise_co_blast_radius_1	/Styles.Icon.command.co_general_blast_radius	
expertise_co_blast_radius_2	/Styles.Icon.command.co_general_blast_radius	
expertise_co_blast_radius_3	/Styles.Icon.command.co_general_blast_radius	
expertise_co_blast_radius_4	/Styles.Icon.command.co_general_blast_radius	
expertise_co_shock_tracer_1	/Styles.Icon.command.co_general_shock_tracer	
expertise_co_burst_fire_1	/Styles.Icon.command.co_general_burst_fire	
expertise_co_burst_fire_2	/Styles.Icon.command.co_general_burst_fire	
expertise_co_keen_eye_1	/Styles.Icon.command.co_general_keen_eye	
expertise_co_keen_eye_2	/Styles.Icon.command.co_general_keen_eye	
expertise_co_strong_arm_1	/Styles.Icon.command.co_general_strong_arm	
expertise_co_strong_arm_2	/Styles.Icon.command.co_general_strong_arm	
expertise_co_strong_arm_3	/Styles.Icon.command.co_general_strong_arm	
expertise_co_strong_arm_4	/Styles.Icon.command.co_general_strong_arm	
expertise_co_voltage_overload_1	/Styles.Icon.command.co_general_voltage_overload	
expertise_co_voltage_overload_2	/Styles.Icon.command.co_general_voltage_overload	
expertise_co_on_target_1	/Styles.Icon.command.co_general_on_target	
expertise_co_on_target_2	/Styles.Icon.command.co_general_on_target	
expertise_co_on_target_3	/Styles.Icon.command.co_general_on_target	
expertise_co_on_target_4	/Styles.Icon.command.co_general_on_target	
expertise_co_heavy_ammunition_1	/Styles.Icon.command.co_general_heavy_ammunition	
expertise_co_heavy_ammunition_2	/Styles.Icon.command.co_general_heavy_ammunition	
expertise_co_heavy_ammunition_3	/Styles.Icon.command.co_general_heavy_ammunition	
expertise_co_heavy_ammunition_4	/Styles.Icon.command.co_general_heavy_ammunition	
expertise_co_packed_explosives_1	/Styles.Icon.command.co_general_packed_explosives	
expertise_co_packed_explosives_2	/Styles.Icon.command.co_general_packed_explosives	
expertise_co_packed_explosives_3	/Styles.Icon.command.co_general_packed_explosives	
expertise_co_packed_explosives_4	/Styles.Icon.command.co_general_packed_explosives	
expertise_co_muscle_spasm_1	/Styles.Icon.command.co_general_muscle_spasm	
expertise_co_muscle_spasm_2	/Styles.Icon.command.co_general_muscle_spasm	
expertise_co_muscle_spasm_3	/Styles.Icon.command.co_general_muscle_spasm	
expertise_co_muscle_spasm_4	/Styles.Icon.command.co_general_muscle_spasm	
expertise_co_base_of_operations_1	/Styles.Icon.command.co_general_base_of_operations	
expertise_co_marksman_1	/Styles.Icon.command.co_marksman	
expertise_co_marksman_2	/Styles.Icon.command.co_marksman	
expertise_co_marksman_3	/Styles.Icon.command.co_marksman	
expertise_co_blast_resistance_1	/Styles.Icon.command.co_general_blast_resistance	
expertise_co_blast_resistance_2	/Styles.Icon.command.co_general_blast_resistance	
expertise_co_blast_resistance_3	/Styles.Icon.command.co_general_blast_resistance	
expertise_co_blast_resistance_4	/Styles.Icon.command.co_general_blast_resistance	
expertise_co_shock_grenade_1	/Styles.Icon.command.co_general_shock_grenade	
expertise_co_stand_fast_1	/Styles.Icon.command.co_stand_fast	
expertise_co_imp_stand_fast_1	/Styles.Icon.command.co_imp_stand_fast	
expertise_co_imp_stand_fast_2	/Styles.Icon.command.co_imp_stand_fast	
expertise_co_imp_stand_fast_3	/Styles.Icon.command.co_imp_stand_fast	
expertise_co_short_fuse_1	/Styles.Icon.command.co_general_shock_grenade	
expertise_co_focus_beam_1	/Styles.Icon.command.co_focus_beam	
expertise_co_tibanna_gas_1	/Styles.Icon.command.co_tibanna_gas	
expertise_co_tibanna_gas_2	/Styles.Icon.command.co_tibanna_gas	
expertise_co_tibanna_gas_3	/Styles.Icon.command.co_tibanna_gas	
expertise_co_tibanna_gas_4	/Styles.Icon.command.co_tibanna_gas	
expertise_co_lethal_beam_1	/Styles.Icon.command.co_lethal_beam	
expertise_co_enhanced_fuel_cans_1	/Styles.Icon.command.co_enhanced_fuel_cans	
expertise_co_enhanced_fuel_cans_2	/Styles.Icon.command.co_enhanced_fuel_cans	
expertise_co_enhanced_fuel_cans_3	/Styles.Icon.command.co_enhanced_fuel_cans	
expertise_co_enhanced_fuel_cans_4	/Styles.Icon.command.co_enhanced_fuel_cans	
expertise_me_hot_duration_1	/Styles.Icon.command.me_hot	
expertise_me_hot_duration_2	/Styles.Icon.command.me_hot	
expertise_me_hot_duration_3	/Styles.Icon.command.me_hot	
expertise_me_hot_duration_4	/Styles.Icon.command.me_hot	
expertise_me_drag	/Styles.Icon.command.me_drag	
expertise_me_revive_duration_1	/Styles.Icon.command.me_rv	
expertise_me_revive_duration_2	/Styles.Icon.command.me_rv	
expertise_me_revive_duration_3	/Styles.Icon.command.me_rv	
expertise_me_blood_cleaners_1	/Styles.Icon.command.me_blood_cleaners	
expertise_me_bacta_bomb_1	/Styles.Icon.command.me_bacta_bomb	
expertise_me_heal_damage_1	/Styles.Icon.command.me_sh	
expertise_me_heal_damage_2	/Styles.Icon.command.me_sh	
expertise_me_heal_damage_3	/Styles.Icon.command.me_sh	
expertise_me_heal_damage_4	/Styles.Icon.command.me_sh	
expertise_me_cure_affliction_1	/Styles.Icon.command.me_cure_affliction	
expertise_me_heal_action_1	/Styles.Icon.command.me_sh	
expertise_me_heal_action_2	/Styles.Icon.command.me_sh	
expertise_me_heal_action_3	/Styles.Icon.command.me_sh	
expertise_me_serotonin_boost_1	/Styles.Icon.command.me_serotonin_boost	
expertise_me_bacta_grenade_1	/Styles.Icon.command.me_bacta_grenade	
expertise_me_enhance_duration_1	/Styles.Icon.command.me_buff_health	
expertise_me_enhance_duration_2	/Styles.Icon.command.me_buff_health	
expertise_me_enhance_duration_3	/Styles.Icon.command.me_buff_health	
expertise_me_enhancement_specialist_1	/Styles.Icon.command.me_enhance_action	
expertise_me_reckless_stimulation_1	/Styles.Icon.command.me_reckless_stimulation	
expertise_me_stasis_1	/Styles.Icon.command.me_stasis	
expertise_me_vital_action_1	/Styles.Icon.command.me_dm	
expertise_me_vital_action_2	/Styles.Icon.command.me_dm	
expertise_me_vital_action_3	/Styles.Icon.command.me_dm	
expertise_me_vital_action_4	/Styles.Icon.command.me_dm	
expertise_me_bacta_resistance_1	/Styles.Icon.command.me_bacta_resistance	
expertise_me_dot_damage_1	/Styles.Icon.command.me_dm_dot	
expertise_me_dot_damage_2	/Styles.Icon.command.me_dm_dot	
expertise_me_dot_damage_3	/Styles.Icon.command.me_dm_dot	
expertise_me_serotonin_purge_1	/Styles.Icon.command.me_serotonin_purge	
expertise_me_induce_insanity_1	/Styles.Icon.command.me_induce_insanity	
expertise_me_vital_damage_1	/Styles.Icon.command.me_dm	
expertise_me_vital_damage_2	/Styles.Icon.command.me_dm	
expertise_me_vital_damage_3	/Styles.Icon.command.me_dm	
expertise_me_vital_damage_4	/Styles.Icon.command.me_dm	
expertise_me_electrolyte_drain_1	/Styles.Icon.command.me_electrolyte_drain	
expertise_me_dot_duration_1	/Styles.Icon.command.me_dm_dot	
expertise_me_dot_duration_2	/Styles.Icon.command.me_dm_dot	
expertise_me_dot_duration_3	/Styles.Icon.command.me_dm_dot	
expertise_me_traumatize_1	/Styles.Icon.command.me_traumatize	
expertise_me_thyroid_rupture_1	/Styles.Icon.command.me_thyroid_rupture	
expertise_me_strength_1	/Styles.Icon.command.fs_general_enhanced_strength	
expertise_me_strength_2	/Styles.Icon.command.fs_general_enhanced_strength	
expertise_me_strength_3	/Styles.Icon.command.fs_general_enhanced_strength	
expertise_me_strength_4	/Styles.Icon.command.fs_general_enhanced_strength	
expertise_me_enhance_strength_1	/Styles.Icon.command.me_enhance_strength	
expertise_me_carbine_damage_1	/Styles.Icon.command.bh_carbine	
expertise_me_carbine_damage_2	/Styles.Icon.command.bh_carbine	
expertise_me_carbine_damage_3	/Styles.Icon.command.bh_carbine	
expertise_me_carbine_damage_4	/Styles.Icon.command.bh_carbine	
expertise_me_dueterium_rounds_1	/Styles.Icon.command.deuteriumToss	
expertise_me_humanoid_crits_1	/Styles.Icon.command.bh_man_crits	
expertise_me_humanoid_crits_2	/Styles.Icon.command.bh_man_crits	
expertise_me_humanoid_crits_3	/Styles.Icon.command.bh_man_crits	
expertise_me_burst_1	/Styles.Icon.command.me_burst	
expertise_me_agility_1	/Styles.Icon.command.fs_general_enhanced_agility	
expertise_me_agility_2	/Styles.Icon.command.fs_general_enhanced_agility	
expertise_me_agility_3	/Styles.Icon.command.fs_general_enhanced_agility	
expertise_me_agility_4	/Styles.Icon.command.fs_general_enhanced_agility	
expertise_me_enhance_agility_1	/Styles.Icon.command.me_enhance_agility	
expertise_me_unarmed_damage_1	/Styles.Icon.command.duelistStance	
expertise_me_unarmed_damage_2	/Styles.Icon.command.duelistStance	
expertise_me_unarmed_damage_3	/Styles.Icon.command.duelistStance	
expertise_me_unarmed_damage_4	/Styles.Icon.command.duelistStance	
expertise_me_poison_knuckle_1	/Styles.Icon.command.infect	
expertise_me_unarmed_crit_1	/Styles.Icon.command.unarmed_crit	
expertise_me_unarmed_crit_2	/Styles.Icon.command.unarmed_crit	
expertise_me_unarmed_crit_3	/Styles.Icon.command.unarmed_crit	
expertise_me_cranial_smash_1	/Styles.Icon.command.me_cranial_smash	
expertise_me_agro_healing_1	/Styles.Icon.command.me_ae_heal	
expertise_me_agro_healing_2	/Styles.Icon.command.me_ae_heal	
expertise_me_agro_healing_3	/Styles.Icon.command.me_ae_heal	
expertise_me_evasion_1	/Styles.Icon.command.me_evasion	
expertise_me_precision_1	/Styles.Icon.command.bh_precision	
expertise_me_precision_2	/Styles.Icon.command.bh_precision	
expertise_me_precision_3	/Styles.Icon.command.bh_precision	
expertise_me_precision_4	/Styles.Icon.command.bh_precision	
expertise_me_enhance_precision_1	/Styles.Icon.command.me_enhance_precision	
expertise_me_kinetic_armor_1	/Styles.Icon.command.bh_armor_kinetic	
expertise_me_kinetic_armor_2	/Styles.Icon.command.bh_armor_kinetic	
expertise_me_kinetic_armor_3	/Styles.Icon.command.bh_armor_kinetic	
expertise_me_kinetic_armor_4	/Styles.Icon.command.bh_armor_kinetic	
expertise_me_enhance_block_1	/Styles.Icon.command.me_enhance_block	
expertise_me_energy_armor_1	/Styles.Icon.command.bh_armor_energy	
expertise_me_energy_armor_2	/Styles.Icon.command.bh_armor_energy	
expertise_me_energy_armor_3	/Styles.Icon.command.bh_armor_energy	
expertise_me_energy_armor_4	/Styles.Icon.command.bh_armor_energy	
expertise_me_enhance_dodge_1	/Styles.Icon.command.me_enhance_dodge	
expertise_sp_quiet_steps_1	/Styles.Icon.command.sp_quiet_steps	
expertise_sp_quiet_steps_2	/Styles.Icon.command.sp_quiet_steps	
expertise_sp_rapid_concealment_1	/Styles.Icon.command.sp_rapid_concealment	
expertise_sp_rapid_concealment_2	/Styles.Icon.command.sp_rapid_concealment	
expertise_sp_rapid_concealment_3	/Styles.Icon.command.sp_rapid_concealment	
expertise_sp_rapid_concealment_4	/Styles.Icon.command.sp_rapid_concealment	
expertise_sp_careful_observation_1	/Styles.Icon.command.sp_careful_observation	
expertise_sp_careful_observation_2	/Styles.Icon.command.sp_careful_observation	
expertise_sp_cloaked_attacks_1	/Styles.Icon.command.sp_cloaked_attacks	
expertise_sp_smoke_screen_1	/Styles.Icon.command.sp_smoke_screen	
expertise_sp_smoke_screen_2	/Styles.Icon.command.sp_smoke_screen	
expertise_sp_smoke_screen_3	/Styles.Icon.command.sp_smoke_screen	
expertise_sp_smoke_screen_4	/Styles.Icon.command.sp_smoke_screen	
expertise_sp_reveal_shadows_1	/Styles.Icon.command.sp_reveal_shadows	
expertise_sp_decoy_1	/Styles.Icon.command.sp_decoy	
expertise_sp_cloak_and_dagger_1	/Styles.Icon.command.sp_cloak_and_dagger	
expertise_sp_cloak_and_dagger_2	/Styles.Icon.command.sp_cloak_and_dagger	
expertise_sp_cloak_and_dagger_3	/Styles.Icon.command.sp_cloak_and_dagger	
expertise_sp_cloak_and_dagger_4	/Styles.Icon.command.sp_cloak_and_dagger	
expertise_sp_burst_of_shadows_1	/Styles.Icon.command.sp_burst_of_shadows	
expertise_sp_expose_shadows_1	/Styles.Icon.command.sp_expose_shadows	
expertise_sp_expose_shadows_2	/Styles.Icon.command.sp_expose_shadows	
expertise_sp_expose_shadows_3	/Styles.Icon.command.sp_expose_shadows	
expertise_sp_expose_shadows_4	/Styles.Icon.command.sp_expose_shadows	
expertise_sp_puncturing_strikes_1	/Styles.Icon.command.sp_puncturing_strikes	
expertise_sp_puncturing_strikes_2	/Styles.Icon.command.sp_puncturing_strikes	
expertise_sp_puncturing_strikes_3	/Styles.Icon.command.sp_puncturing_strikes	
expertise_sp_puncturing_strikes_4	/Styles.Icon.command.sp_puncturing_strikes	
expertise_sp_steup_1	/Styles.Icon.command.sp_setup	
expertise_sp_steup_2	/Styles.Icon.command.sp_setup	
expertise_sp_steup_3	/Styles.Icon.command.sp_setup	
expertise_sp_steup_4	/Styles.Icon.command.sp_setup	
expertise_sp_shadows_embrace_1	/Styles.Icon.command.sp_shadows_embrace	
expertise_sp_shadows_embrace_2	/Styles.Icon.command.sp_shadows_embrace	
expertise_sp_shadows_embrace_3	/Styles.Icon.command.sp_shadows_embrace	
expertise_sp_shadows_embrace_4	/Styles.Icon.command.sp_shadows_embrace	
expertise_sp_undercover_1	/Styles.Icon.command.sp_undercover	
expertise_sp_undercover_2	/Styles.Icon.command.sp_undercover	
expertise_sp_undercover_3	/Styles.Icon.command.sp_undercover	
expertise_sp_initiative_1	/Styles.Icon.command.sp_initiative	
expertise_sp_initiative_2	/Styles.Icon.command.sp_initiative	
expertise_sp_initiative_3	/Styles.Icon.command.sp_initiative	
expertise_sp_initiative_4	/Styles.Icon.command.sp_initiative	
expertise_sp_without_a_trace_1	/Styles.Icon.command.sp_without_a_trace	
expertise_sp_covert_mastery_1	/Styles.Icon.command.sp_covert_mastery	
expertise_sp_covert_mastery_2	/Styles.Icon.command.sp_covert_mastery	
expertise_sp_covert_mastery_3	/Styles.Icon.command.sp_covert_mastery	
expertise_sp_covert_mastery_4	/Styles.Icon.command.sp_covert_mastery	
expertise_sp_diversion_1	/Styles.Icon.command.sp_diversion	
expertise_sp_diversion_2	/Styles.Icon.command.sp_diversion	
expertise_sp_preparation_1	/Styles.Icon.command.sp_preparation	
expertise_sp_improved_spys_fang_1	/Styles.Icon.command.sp_improved_spys_fang	
expertise_sp_hidden_daggers_1	/Styles.Icon.command.sp_hd_ability	
expertise_sp_hidden_daggers_2	/Styles.Icon.command.sp_hd_ability	
expertise_sp_improved_first_aid_1	/Styles.Icon.command.sp_improved_first_aid	
expertise_sp_improved_first_aid_2	/Styles.Icon.command.sp_improved_first_aid	
expertise_sp_cloaked_recovery_1	/Styles.Icon.command.sp_cloaked_recovery	
expertise_sp_protective_armor_1	/Styles.Icon.command.sp_protective_armor	
expertise_sp_protective_armor_2	/Styles.Icon.command.sp_protective_armor	
expertise_sp_protective_armor_3	/Styles.Icon.command.sp_protective_armor	
expertise_sp_protective_armor_4	/Styles.Icon.command.sp_protective_armor	
expertise_sp_improved_arachnids_web_1	/Styles.Icon.command.sp_improved_arachnids_web	
expertise_sp_run_its_course_1	/Styles.Icon.command.sp_run_its_course	
expertise_sp_noxious_traps_1	/Styles.Icon.command.sp_noxious_traps	
expertise_sp_noxious_traps_2	/Styles.Icon.command.sp_noxious_traps	
expertise_sp_cloaking_armor_1	/Styles.Icon.command.sp_cloaking_armor	
expertise_sp_cloaking_armor_2	/Styles.Icon.command.sp_cloaking_armor	
expertise_sp_cloaking_armor_3	/Styles.Icon.command.sp_cloaking_armor	
expertise_sp_opportunity_1	/Styles.Icon.command.sp_opportunity	
expertise_sp_opportunity_2	/Styles.Icon.command.sp_opportunity	
expertise_sp_opportunity_3	/Styles.Icon.command.sp_opportunity	
expertise_sp_opportunity_4	/Styles.Icon.command.sp_opportunity	
expertise_sp_precision_1	/Styles.Icon.command.sp_precision	
expertise_sp_precision_2	/Styles.Icon.command.sp_precision	
expertise_sp_precision_3	/Styles.Icon.command.sp_precision	
expertise_sp_precision_4	/Styles.Icon.command.sp_precision	
expertise_sp_increased_strength_1	/Styles.Icon.command.sp_increased_strength	
expertise_sp_increased_strength_2	/Styles.Icon.command.sp_increased_strength	
expertise_sp_increased_strength_3	/Styles.Icon.command.sp_increased_strength	
expertise_sp_increased_strength_4	/Styles.Icon.command.sp_increased_strength	
expertise_sp_glancing_armor_1	/Styles.Icon.command.sp_glancing_armor	
expertise_sp_glancing_armor_2	/Styles.Icon.command.sp_glancing_armor	
expertise_sp_deadly_pistols_1	/Styles.Icon.command.sp_deadly_pistols	
expertise_sp_deadly_pistols_2	/Styles.Icon.command.sp_deadly_pistols	
expertise_sp_deadly_pistols_3	/Styles.Icon.command.sp_deadly_pistols	
expertise_sp_close_quarters_1	/Styles.Icon.command.sp_close_quarters	
expertise_sp_close_quarters_2	/Styles.Icon.command.sp_close_quarters	
expertise_sp_close_quarters_3	/Styles.Icon.command.sp_close_quarters	
expertise_sp_deadly_toxins_1	/Styles.Icon.command.sp_deadly_toxins	
expertise_sp_deadly_toxins_2	/Styles.Icon.command.sp_deadly_toxins	
expertise_sp_increased_agility_1	/Styles.Icon.command.sp_increased_agility	
expertise_sp_increased_agility_2	/Styles.Icon.command.sp_increased_agility	
expertise_sp_increased_agility_3	/Styles.Icon.command.sp_increased_agility	
expertise_sp_increased_agility_4	/Styles.Icon.command.sp_increased_agility	
expertise_sp_cheap_shots_1	/Styles.Icon.command.sp_cheap_shots	
expertise_sp_cheap_shots_2	/Styles.Icon.command.sp_cheap_shots	
expertise_sp_cheap_shots_3	/Styles.Icon.command.sp_cheap_shots	
expertise_sp_cheap_shots_4	/Styles.Icon.command.sp_cheap_shots	
expertise_sp_cheap_strikes_1	/Styles.Icon.command.sp_cheap_strikes	
expertise_sp_cheap_strikes_2	/Styles.Icon.command.sp_cheap_strikes	
expertise_sp_cheap_strikes_3	/Styles.Icon.command.sp_cheap_strikes	
expertise_sp_cheap_strikes_4	/Styles.Icon.command.sp_cheap_strikes	
expertise_sp_crippling_traps_1	/Styles.Icon.command.sp_crippling_traps	
expertise_sp_crippling_traps_2	/Styles.Icon.command.sp_crippling_traps	
expertise_sp_avoid_damage_1	/Styles.Icon.command.sp_avoid_damage	
expertise_sp_smoke_mirrors	/Styles.Icon.command.sp_smoke_mirrors	
expertise_sp_jagged_edge_1	/Styles.Icon.command.sp_jagged_edge	
expertise_sp_jagged_edge_2	/Styles.Icon.command.sp_jagged_edge	
expertise_sp_jagged_edge_3	/Styles.Icon.command.sp_jagged_edge	
expertise_sp_savagery	/Styles.Icon.command.sp_savagery	
expertise_sp_assassins_blade_1	/Styles.Icon.command.sp_assassins_blade	
expertise_sp_assassins_blade_2	/Styles.Icon.command.sp_assassins_blade	
expertise_sp_vibrogenerator_1	/Styles.Icon.command.sp_vibrogenerator	
expertise_sp_vibrogenerator_2	/Styles.Icon.command.sp_vibrogenerator	
expertise_sp_vibrogenerator_3	/Styles.Icon.command.sp_vibrogenerator	
expertise_sp_resonance	/Styles.Icon.command.sp_resonance	
expertise_sp_equilibrium	/Styles.Icon.command.sp_equilibrium	
expertise_sp_assassins_mark	/Styles.Icon.command.sp_assassins_mark	
expertise_sp_shifty_setup_1	/Styles.Icon.command.sp_shifty_setup	
expertise_trader_business_accounting_1	/Styles.Icon.command.trader_business_accounting	
expertise_trader_business_accounting_2	/Styles.Icon.command.trader_business_accounting	
expertise_trader_business_accounting_3	/Styles.Icon.command.trader_business_accounting	
expertise_trader_business_accounting_4	/Styles.Icon.command.trader_business_accounting	
expertise_trader_sampling_collection_1	/Styles.Icon.command.trader_sampling_collection	
expertise_trader_sampling_collection_2	/Styles.Icon.command.trader_sampling_collection	
expertise_trader_sampling_collection_3	/Styles.Icon.command.trader_sampling_collection	
expertise_trader_sampling_collection_4	/Styles.Icon.command.trader_sampling_collection	
expertise_trader_warehousing_1	/Styles.Icon.command.trader_warehousing	
expertise_trader_warehousing_2	/Styles.Icon.command.trader_warehousing	
expertise_trader_warehousing_3	/Styles.Icon.command.trader_warehousing	
expertise_trader_warehousing_4	/Styles.Icon.command.trader_warehousing	
expertise_trader_harvester_storage_1	/Styles.Icon.command.trader_harvester_storage	
expertise_trader_harvester_storage_2	/Styles.Icon.command.trader_harvester_storage	
expertise_trader_harvester_storage_3	/Styles.Icon.command.trader_harvester_storage	
expertise_trader_harvester_storage_4	/Styles.Icon.command.trader_harvester_storage	
expertise_trader_sampling_efficiency_1	/Styles.Icon.command.trader_sampling_efficiency	
expertise_trader_sampling_efficiency_2	/Styles.Icon.command.trader_sampling_efficiency	
expertise_trader_sampling_efficiency_3	/Styles.Icon.command.trader_sampling_efficiency	
expertise_trader_personnel_management_1	/Styles.Icon.command.trader_personnel_management	
expertise_trader_personnel_management_2	/Styles.Icon.command.trader_personnel_management	
expertise_trader_factory_maintenance_1	/Styles.Icon.command.trader_factory_maintenance	
expertise_trader_factory_maintenance_2	/Styles.Icon.command.trader_factory_maintenance	
expertise_trader_factory_maintenance_3	/Styles.Icon.command.trader_factory_maintenance	
expertise_trader_factory_maintenance_4	/Styles.Icon.command.trader_factory_maintenance	
expertise_trader_harvester_maintenance_1	/Styles.Icon.command.trader_harvester_maintenance	
expertise_trader_harvester_maintenance_2	/Styles.Icon.command.trader_harvester_maintenance	
expertise_trader_harvester_maintenance_3	/Styles.Icon.command.trader_harvester_maintenance	
expertise_trader_harvester_maintenance_4	/Styles.Icon.command.trader_harvester_maintenance	
expertise_trader_factory_energy_1	/Styles.Icon.command.trader_factory_energy	
expertise_trader_factory_energy_2	/Styles.Icon.command.trader_factory_energy	
expertise_trader_factory_energy_3	/Styles.Icon.command.trader_factory_energy	
expertise_trader_factory_energy_4	/Styles.Icon.command.trader_factory_energy	
expertise_trader_harvester_energy_1	/Styles.Icon.command.trader_harvester_energy	
expertise_trader_harvester_energy_2	/Styles.Icon.command.trader_harvester_energy	
expertise_trader_harvester_energy_3	/Styles.Icon.command.trader_harvester_energy	
expertise_trader_harvester_energy_4	/Styles.Icon.command.trader_harvester_energy	
expertise_trader_reverse_engineering_1	/Styles.Icon.command.trader_reverse_engineering	
expertise_trader_reverse_engineering_2	/Styles.Icon.command.trader_reverse_engineering	
expertise_trader_factory_production_1	/Styles.Icon.command.trader_factory_production	
expertise_trader_factory_production_2	/Styles.Icon.command.trader_factory_production	
expertise_trader_harvester_collection_1	/Styles.Icon.command.trader_harvester_collection	
expertise_trader_harvester_collection_2	/Styles.Icon.command.trader_harvester_collection	
expertise_domestic_tailor_dexterity_1	/Styles.Icon.command.trader_profession_1_dexterity	
expertise_domestic_tailor_dexterity_2	/Styles.Icon.command.trader_profession_1_dexterity	
expertise_domestic_tailor_dexterity_3	/Styles.Icon.command.trader_profession_1_dexterity	
expertise_domestic_tailor_dexterity_4	/Styles.Icon.command.trader_profession_1_dexterity	
expertise_domestic_artisan_dexterity_1	/Styles.Icon.command.trader_artisan_dexterity	
expertise_domestic_artisan_dexterity_2	/Styles.Icon.command.trader_artisan_dexterity	
expertise_domestic_artisan_dexterity_3	/Styles.Icon.command.trader_artisan_dexterity	
expertise_domestic_artisan_dexterity_4	/Styles.Icon.command.trader_artisan_dexterity	
expertise_domestic_chef_dexterity_1	/Styles.Icon.command.trader_profession_2_dexterity	
expertise_domestic_chef_dexterity_2	/Styles.Icon.command.trader_profession_2_dexterity	
expertise_domestic_chef_dexterity_3	/Styles.Icon.command.trader_profession_2_dexterity	
expertise_domestic_chef_dexterity_4	/Styles.Icon.command.trader_profession_2_dexterity	
expertise_domestic_tailor_insight_1	/Styles.Icon.command.trader_profession_1_insight	
expertise_domestic_tailor_insight_2	/Styles.Icon.command.trader_profession_1_insight	
expertise_domestic_artisan_hypothesis_1	/Styles.Icon.command.trader_artisan_hypothesis	
expertise_domestic_artisan_hypothesis_2	/Styles.Icon.command.trader_artisan_hypothesis	
expertise_domestic_artisan_hypothesis_3	/Styles.Icon.command.trader_artisan_hypothesis	
expertise_domestic_artisan_hypothesis_4	/Styles.Icon.command.trader_artisan_hypothesis	
expertise_domestic_chef_insight_1	/Styles.Icon.command.trader_profession_2_insight	
expertise_domestic_chef_insight_2	/Styles.Icon.command.trader_profession_2_insight	
expertise_domestic_tailor_hypothesis_1	/Styles.Icon.command.trader_profession_1_hypothesis	
expertise_domestic_tailor_hypothesis_2	/Styles.Icon.command.trader_profession_1_hypothesis	
expertise_domestic_tailor_hypothesis_3	/Styles.Icon.command.trader_profession_1_hypothesis	
expertise_domestic_tailor_hypothesis_4	/Styles.Icon.command.trader_profession_1_hypothesis	
expertise_domestic_resource_processing_1	/Styles.Icon.command.trader_resource_processing	
expertise_domestic_resource_processing_2	/Styles.Icon.command.trader_resource_processing	
expertise_domestic_chef_hypothesis_1	/Styles.Icon.command.trader_profession_2_hypothesis	
expertise_domestic_chef_hypothesis_2	/Styles.Icon.command.trader_profession_2_hypothesis	
expertise_domestic_chef_hypothesis_3	/Styles.Icon.command.trader_profession_2_hypothesis	
expertise_domestic_chef_hypothesis_4	/Styles.Icon.command.trader_profession_2_hypothesis	
expertise_domestic_tailor_keen_understanding_1	/Styles.Icon.command.trader_profession_1_keen_understanding	
expertise_domestic_tailor_keen_understanding_2	/Styles.Icon.command.trader_profession_1_keen_understanding	
expertise_domestic_resource_refinement_1	/Styles.Icon.command.trader_resource_refinement	
expertise_domestic_resource_refinement_2	/Styles.Icon.command.trader_resource_refinement	
expertise_domestic_artisan_advanced_theory_1	/Styles.Icon.command.trader_artisan_advanced_theory	
expertise_domestic_chef_keen_understanding_1	/Styles.Icon.command.trader_profession_2_keen_understanding	
expertise_domestic_chef_keen_understanding_2	/Styles.Icon.command.trader_profession_2_keen_understanding	
expertise_domestic_tailor_advanced_theory_1	/Styles.Icon.command.trader_profession_1_advanced_theory	
expertise_domestic_tailor_socket_bonus_1	/Styles.Icon.command.trader_profession_1_socket_bonus	
expertise_domestic_tailor_attachment_upgrade_1	/Styles.Icon.command.trader_profession_1_attachment_bonus	
expertise_domestic_chef_schematic_1_1	/Styles.Icon.command.trader_profession_2_first_schematic	
expertise_domestic_chef_schematic_2_1	/Styles.Icon.command.trader_profession_2_second_schematic	
expertise_domestic_chef_advanced_theory_1	/Styles.Icon.command.trader_profession_2_advanced_theory	
expertise_structure_architect_dexterity_1	/Styles.Icon.command.trader_profession_1_dexterity	
expertise_structure_architect_dexterity_2	/Styles.Icon.command.trader_profession_1_dexterity	
expertise_structure_architect_dexterity_3	/Styles.Icon.command.trader_profession_1_dexterity	
expertise_structure_architect_dexterity_4	/Styles.Icon.command.trader_profession_1_dexterity	
expertise_structure_artisan_dexterity_1	/Styles.Icon.command.trader_artisan_dexterity	
expertise_structure_artisan_dexterity_2	/Styles.Icon.command.trader_artisan_dexterity	
expertise_structure_artisan_dexterity_3	/Styles.Icon.command.trader_artisan_dexterity	
expertise_structure_artisan_dexterity_4	/Styles.Icon.command.trader_artisan_dexterity	
expertise_structure_shipwright_dexterity_1	/Styles.Icon.command.trader_profession_2_dexterity	
expertise_structure_shipwright_dexterity_2	/Styles.Icon.command.trader_profession_2_dexterity	
expertise_structure_shipwright_dexterity_3	/Styles.Icon.command.trader_profession_2_dexterity	
expertise_structure_shipwright_dexterity_4	/Styles.Icon.command.trader_profession_2_dexterity	
expertise_structure_architect_insight_1	/Styles.Icon.command.trader_profession_1_insight	
expertise_structure_architect_insight_2	/Styles.Icon.command.trader_profession_1_insight	
expertise_structure_artisan_hypothesis_1	/Styles.Icon.command.trader_artisan_hypothesis	
expertise_structure_artisan_hypothesis_2	/Styles.Icon.command.trader_artisan_hypothesis	
expertise_structure_artisan_hypothesis_3	/Styles.Icon.command.trader_artisan_hypothesis	
expertise_structure_artisan_hypothesis_4	/Styles.Icon.command.trader_artisan_hypothesis	
expertise_structure_shipwright_insight_1	/Styles.Icon.command.trader_profession_2_insight	
expertise_structure_shipwright_insight_2	/Styles.Icon.command.trader_profession_2_insight	
expertise_structure_architect_hypothesis_1	/Styles.Icon.command.trader_profession_1_hypothesis	
expertise_structure_architect_hypothesis_2	/Styles.Icon.command.trader_profession_1_hypothesis	
expertise_structure_architect_hypothesis_3	/Styles.Icon.command.trader_profession_1_hypothesis	
expertise_structure_architect_hypothesis_4	/Styles.Icon.command.trader_profession_1_hypothesis	
expertise_structure_resource_processing_1	/Styles.Icon.command.trader_resource_processing	
expertise_structure_resource_processing_2	/Styles.Icon.command.trader_resource_processing	
expertise_structure_shipwright_hypothesis_1	/Styles.Icon.command.trader_profession_2_hypothesis	
expertise_structure_shipwright_hypothesis_2	/Styles.Icon.command.trader_profession_2_hypothesis	
expertise_structure_shipwright_hypothesis_3	/Styles.Icon.command.trader_profession_2_hypothesis	
expertise_structure_shipwright_hypothesis_4	/Styles.Icon.command.trader_profession_2_hypothesis	
expertise_structure_architect_keen_understanding_1	/Styles.Icon.command.trader_profession_1_keen_understanding	
expertise_structure_architect_keen_understanding_2	/Styles.Icon.command.trader_profession_1_keen_understanding	
expertise_structure_resource_refinement_1	/Styles.Icon.command.trader_resource_refinement	
expertise_structure_resource_refinement_2	/Styles.Icon.command.trader_resource_refinement	
expertise_structure_artisan_advanced_theory_1	/Styles.Icon.command.trader_artisan_advanced_theory	
expertise_structure_shipwright_keen_understanding_1	/Styles.Icon.command.trader_profession_2_keen_understanding	
expertise_structure_shipwright_keen_understanding_2	/Styles.Icon.command.trader_profession_2_keen_understanding	
expertise_structure_architect_advanced_theory_1	/Styles.Icon.command.trader_profession_1_advanced_theory	
expertise_structure_architect_schematic_1_1	/Styles.Icon.command.trader_profession_1_first_schematic	
expertise_structure_architect_schematic_2_1	/Styles.Icon.command.trader_profession_1_second_schematic	
expertise_structure_shipwright_schematic_1_1	/Styles.Icon.command.trader_profession_2_first_schematic	
expertise_structure_shipwright_schematic_2_1	/Styles.Icon.command.trader_profession_2_second_schematic	
expertise_structure_shipwright_advanced_theory_1	/Styles.Icon.command.trader_profession_2_advanced_theory	
expertise_munition_weaponsmith_dexterity_1	/Styles.Icon.command.trader_profession_1_dexterity	
expertise_munition_weaponsmith_dexterity_2	/Styles.Icon.command.trader_profession_1_dexterity	
expertise_munition_weaponsmith_dexterity_3	/Styles.Icon.command.trader_profession_1_dexterity	
expertise_munition_weaponsmith_dexterity_4	/Styles.Icon.command.trader_profession_1_dexterity	
expertise_munition_artisan_dexterity_1	/Styles.Icon.command.trader_artisan_dexterity	
expertise_munition_artisan_dexterity_2	/Styles.Icon.command.trader_artisan_dexterity	
expertise_munition_artisan_dexterity_3	/Styles.Icon.command.trader_artisan_dexterity	
expertise_munition_artisan_dexterity_4	/Styles.Icon.command.trader_artisan_dexterity	
expertise_munition_armorsmith_dexterity_1	/Styles.Icon.command.trader_profession_2_dexterity	
expertise_munition_armorsmith_dexterity_2	/Styles.Icon.command.trader_profession_2_dexterity	
expertise_munition_armorsmith_dexterity_3	/Styles.Icon.command.trader_profession_2_dexterity	
expertise_munition_armorsmith_dexterity_4	/Styles.Icon.command.trader_profession_2_dexterity	
expertise_munition_weaponsmith_insight_1	/Styles.Icon.command.trader_profession_1_insight	
expertise_munition_weaponsmith_insight_2	/Styles.Icon.command.trader_profession_1_insight	
expertise_munition_artisan_hypothesis_1	/Styles.Icon.command.trader_artisan_hypothesis	
expertise_munition_artisan_hypothesis_2	/Styles.Icon.command.trader_artisan_hypothesis	
expertise_munition_artisan_hypothesis_3	/Styles.Icon.command.trader_artisan_hypothesis	
expertise_munition_artisan_hypothesis_4	/Styles.Icon.command.trader_artisan_hypothesis	
expertise_munition_armorsmith_insight_1	/Styles.Icon.command.trader_profession_2_insight	
expertise_munition_armorsmith_insight_2	/Styles.Icon.command.trader_profession_2_insight	
expertise_munition_weaponsmith_hypothesis_1	/Styles.Icon.command.trader_profession_1_hypothesis	
expertise_munition_weaponsmith_hypothesis_2	/Styles.Icon.command.trader_profession_1_hypothesis	
expertise_munition_weaponsmith_hypothesis_3	/Styles.Icon.command.trader_profession_1_hypothesis	
expertise_munition_weaponsmith_hypothesis_4	/Styles.Icon.command.trader_profession_1_hypothesis	
expertise_munition_resource_processing_1	/Styles.Icon.command.trader_resource_processing	
expertise_munition_resource_processing_2	/Styles.Icon.command.trader_resource_processing	
expertise_munition_armorsmith_hypothesis_1	/Styles.Icon.command.trader_profession_2_hypothesis	
expertise_munition_armorsmith_hypothesis_2	/Styles.Icon.command.trader_profession_2_hypothesis	
expertise_munition_armorsmith_hypothesis_3	/Styles.Icon.command.trader_profession_2_hypothesis	
expertise_munition_armorsmith_hypothesis_4	/Styles.Icon.command.trader_profession_2_hypothesis	
expertise_munition_weaponsmith_keen_understanding_1	/Styles.Icon.command.trader_profession_1_keen_understanding	
expertise_munition_weaponsmith_keen_understanding_2	/Styles.Icon.command.trader_profession_1_keen_understanding	
expertise_munition_resource_refinement_1	/Styles.Icon.command.trader_resource_refinement	
expertise_munition_resource_refinement_2	/Styles.Icon.command.trader_resource_refinement	
expertise_munition_artisan_advanced_theory_1	/Styles.Icon.command.trader_artisan_advanced_theory	
expertise_munition_armorsmith_keen_understanding_1	/Styles.Icon.command.trader_profession_2_keen_understanding	
expertise_munition_armorsmith_keen_understanding_2	/Styles.Icon.command.trader_profession_2_keen_understanding	
expertise_munition_weaponsmith_advanced_theory_1	/Styles.Icon.command.trader_profession_1_advanced_theory	
expertise_munition_weaponsmith_socket_bonus_1	/Styles.Icon.command.trader_profession_1_socket_bonus	
expertise_munition_weaponsmith_attachment_upgrade_1	/Styles.Icon.command.trader_profession_1_attachment_bonus	
expertise_munition_armorsmith_attachment_upgrade_1	/Styles.Icon.command.trader_profession_2_attachment_bonus	
expertise_munition_armorsmith_socket_bonus_1	/Styles.Icon.command.trader_profession_2_socket_bonus	
expertise_munition_armorsmith_advanced_theory_1	/Styles.Icon.command.trader_profession_2_advanced_theory	
expertise_cybernetic_dexterity_1	/Styles.Icon.command.trader_profession_2_dexterity	
expertise_cybernetic_dexterity_2	/Styles.Icon.command.trader_profession_2_dexterity	
expertise_cybernetic_dexterity_3	/Styles.Icon.command.trader_profession_2_dexterity	
expertise_cybernetic_dexterity_4	/Styles.Icon.command.trader_profession_2_dexterity	
expertise_engineering_cybernetic_hypothesis_1	/Styles.Icon.command.trader_profession_2_hypothesis	
expertise_engineering_cybernetic_hypothesis_2	/Styles.Icon.command.trader_profession_2_hypothesis	
expertise_engineering_cybernetic_hypothesis_3	/Styles.Icon.command.trader_profession_2_hypothesis	
expertise_engineering_cybernetic_hypothesis_4	/Styles.Icon.command.trader_profession_2_hypothesis	
expertise_engineering_cybernetic_advanced_theory_1	/Styles.Icon.command.trader_profession_2_advanced_theory	
expertise_engineering_cybernetic_s03_schematics_1	/Styles.Icon.command.cybernetic_s03_schematics	
expertise_engineering_cybernetic_negative_effects_reduction_1	/Styles.Icon.command.cybernetic_armor_effects_reduction	
expertise_engineering_cybernetic_negative_effects_reduction_2	/Styles.Icon.command.cybernetic_armor_effects_reduction	
expertise_engineering_cybernetic_negative_effects_reduction_3	/Styles.Icon.command.cybernetic_armor_effects_reduction	
expertise_engineering_cybernetic_negative_effects_reduction_4	/Styles.Icon.command.cybernetic_armor_effects_reduction	
expertise_engineering_droid_dexterity_1	/Styles.Icon.command.trader_profession_1_dexterity	
expertise_engineering_droid_dexterity_2	/Styles.Icon.command.trader_profession_1_dexterity	
expertise_engineering_droid_dexterity_3	/Styles.Icon.command.trader_profession_1_dexterity	
expertise_engineering_droid_dexterity_4	/Styles.Icon.command.trader_profession_1_dexterity	
expertise_engineering_artisan_dexterity_1	/Styles.Icon.command.trader_artisan_dexterity	
expertise_engineering_artisan_dexterity_2	/Styles.Icon.command.trader_artisan_dexterity	
expertise_engineering_artisan_dexterity_3	/Styles.Icon.command.trader_artisan_dexterity	
expertise_engineering_artisan_dexterity_4	/Styles.Icon.command.trader_artisan_dexterity	
expertise_engineering_flame_jet_1	/Styles.Icon.command.droid_flame_jet	
expertise_engineering_electrical_shock_1	/Styles.Icon.command.droid_electrical_shock	
expertise_engineering_sticky_fuel_1	/Styles.Icon.command.droid_sticky_fuel	
expertise_engineering_sticky_fuel_2	/Styles.Icon.command.droid_sticky_fuel	
expertise_engineering_varied_voltage_1	/Styles.Icon.command.droid_varied_voltage	
expertise_engineering_varied_voltage_2	/Styles.Icon.command.droid_varied_voltage	
expertise_engineering_droideka_shield_1	/Styles.Icon.command.droid_droideka_shield	
expertise_engineering_torturous_needle_1	/Styles.Icon.command.droid_torturous_needle	
expertise_engineering_shield_expansion_1	/Styles.Icon.command.droid_shield_expansion	
expertise_engineering_shield_expansion_2	/Styles.Icon.command.droid_shield_expansion	
expertise_engineering_noxious_spray_1	/Styles.Icon.command.droid_noxious_spray	
expertise_engineering_noxious_spray_2	/Styles.Icon.command.droid_noxious_spray	
expertise_engineering_regenerative_plating_1	/Styles.Icon.command.droid_regenerative_plating	
expertise_engineering_battery_dump_1	/Styles.Icon.command.droid_battery_dump	
expertise_engineering_weaponsmith_dexterity_1	/Styles.Icon.command.trader_profession_2_dexterity	
expertise_engineering_weaponsmith_dexterity_2	/Styles.Icon.command.trader_profession_2_dexterity	
expertise_engineering_weaponsmith_dexterity_3	/Styles.Icon.command.trader_profession_2_dexterity	
expertise_engineering_weaponsmith_dexterity_4	/Styles.Icon.command.trader_profession_2_dexterity	
expertise_engineering_droid_insight_1	/Styles.Icon.command.trader_profession_1_insight	
expertise_engineering_droid_insight_2	/Styles.Icon.command.trader_profession_1_insight	
expertise_engineering_artisan_hypothesis_1	/Styles.Icon.command.trader_artisan_hypothesis	
expertise_engineering_artisan_hypothesis_2	/Styles.Icon.command.trader_artisan_hypothesis	
expertise_engineering_artisan_hypothesis_3	/Styles.Icon.command.trader_artisan_hypothesis	
expertise_engineering_artisan_hypothesis_4	/Styles.Icon.command.trader_artisan_hypothesis	
expertise_engineering_weaponsmith_insight_1	/Styles.Icon.command.trader_profession_2_insight	
expertise_engineering_weaponsmith_insight_2	/Styles.Icon.command.trader_profession_2_insight	
expertise_engineering_droid_hypothesis_1	/Styles.Icon.command.trader_profession_1_hypothesis	
expertise_engineering_droid_hypothesis_2	/Styles.Icon.command.trader_profession_1_hypothesis	
expertise_engineering_droid_hypothesis_3	/Styles.Icon.command.trader_profession_1_hypothesis	
expertise_engineering_droid_hypothesis_4	/Styles.Icon.command.trader_profession_1_hypothesis	
expertise_engineering_resource_processing_1	/Styles.Icon.command.trader_resource_processing	
expertise_engineering_resource_processing_2	/Styles.Icon.command.trader_resource_processing	
expertise_engineering_weaponsmith_hypothesis_1	/Styles.Icon.command.trader_profession_2_hypothesis	
expertise_engineering_weaponsmith_hypothesis_2	/Styles.Icon.command.trader_profession_2_hypothesis	
expertise_engineering_weaponsmith_hypothesis_3	/Styles.Icon.command.trader_profession_2_hypothesis	
expertise_engineering_weaponsmith_hypothesis_4	/Styles.Icon.command.trader_profession_2_hypothesis	
expertise_engineering_droid_keen_understanding_1	/Styles.Icon.command.trader_profession_1_keen_understanding	
expertise_engineering_droid_keen_understanding_2	/Styles.Icon.command.trader_profession_1_keen_understanding	
expertise_engineering_resource_refinement_1	/Styles.Icon.command.trader_resource_refinement	
expertise_engineering_resource_refinement_2	/Styles.Icon.command.trader_resource_refinement	
expertise_engineering_artisan_advanced_theory_1	/Styles.Icon.command.trader_artisan_advanced_theory	
expertise_engineering_weaponsmith_keen_understanding_1	/Styles.Icon.command.trader_profession_2_keen_understanding	
expertise_engineering_weaponsmith_keen_understanding_2	/Styles.Icon.command.trader_profession_2_keen_understanding	
expertise_engineering_droid_advanced_theory_1	/Styles.Icon.command.trader_profession_1_advanced_theory	
expertise_engineering_droid_schematic_1_1	/Styles.Icon.command.trader_profession_1_first_schematic	
expertise_engineering_droid_schematic_2_1	/Styles.Icon.command.trader_profession_1_second_schematic	
expertise_engineering_weaponsmith_attachment_upgrade_1	/Styles.Icon.command.trader_profession_2_attachment_bonus	
expertise_engineering_weaponsmith_socket_bonus_1	/Styles.Icon.command.trader_profession_2_socket_bonus	
expertise_engineering_weaponsmith_advanced_theory_1	/Styles.Icon.command.trader_profession_2_advanced_theory	
expertise_en_inspired_fitness_1	/Styles.Icon.command.en_inspired_fitness	
expertise_en_inspired_fitness_2	/Styles.Icon.command.en_inspired_fitness	
expertise_en_inspired_fitness_3	/Styles.Icon.command.en_inspired_fitness	
expertise_en_inspired_fitness_4	/Styles.Icon.command.en_inspired_fitness	
expertise_en_inspired_resilience_1	/Styles.Icon.command.en_inspired_resilience	
expertise_en_inspired_resilience_2	/Styles.Icon.command.en_inspired_resilience	
expertise_en_inspired_resilience_3	/Styles.Icon.command.en_inspired_resilience	
expertise_en_inspired_resilience_4	/Styles.Icon.command.en_inspired_resilience	
expertise_en_inspired_industry_1	/Styles.Icon.command.en_inspired_industry	
expertise_en_inspired_industry_2	/Styles.Icon.command.en_inspired_industry	
expertise_en_inspired_industry_3	/Styles.Icon.command.en_inspired_industry	
expertise_en_inspired_industry_4	/Styles.Icon.command.en_inspired_industry	
expertise_en_creativity_1	/Styles.Icon.command.en_creativity	
expertise_en_creativity_2	/Styles.Icon.command.en_creativity	
expertise_en_creativity_3	/Styles.Icon.command.en_creativity	
expertise_en_creativity_4	/Styles.Icon.command.en_creativity	
expertise_en_holism_1	/Styles.Icon.command.en_healer_buff_package	
expertise_en_harvest_faire_1	/Styles.Icon.command.en_harvest_faire_buff_package	
expertise_en_second_chance_1	/Styles.Icon.command.en_second_chance_buff_package	
expertise_en_go_with_the_flow_1	/Styles.Icon.command.en_go_with_the_flow_buff_package	
expertise_en_intense_performer_1	/Styles.Icon.command.en_intense_performer	
expertise_en_intense_performer_2	/Styles.Icon.command.en_intense_performer	
expertise_en_intense_performer_3	/Styles.Icon.command.en_intense_performer	
expertise_en_intense_performer_4	/Styles.Icon.command.en_intense_performer	
expertise_en_affability_1	/Styles.Icon.command.en_affability	
expertise_en_affability_2	/Styles.Icon.command.en_affability	
expertise_en_affability_3	/Styles.Icon.command.en_affability	
expertise_en_affability_4	/Styles.Icon.command.en_affability	
expertise_en_flush_with_success_1	/Styles.Icon.command.en_flush_with_success_buff_package	
expertise_en_inspired_reactions_1	/Styles.Icon.command.en_inspired_reactions	
expertise_en_inspired_reactions_2	/Styles.Icon.command.en_inspired_reactions	
expertise_en_inspired_reactions_3	/Styles.Icon.command.en_inspired_reactions	
expertise_en_inspired_reactions_4	/Styles.Icon.command.en_inspired_reactions	
expertise_en_lasting_impression_1	/Styles.Icon.command.en_lasting_impression	
expertise_en_lasting_impression_2	/Styles.Icon.command.en_lasting_impression	
expertise_en_lasting_impression_3	/Styles.Icon.command.en_lasting_impression	
expertise_en_lasting_impression_4	/Styles.Icon.command.en_lasting_impression	
expertise_en_holography_1	/Styles.Icon.command.en_holographic_image	
expertise_en_inspired_warfare_1	/Styles.Icon.command.en_inspired_warfare	
expertise_en_inspired_warfare_2	/Styles.Icon.command.en_inspired_warfare	
expertise_en_inspired_warfare_3	/Styles.Icon.command.en_inspired_warfare	
expertise_en_inspired_warfare_4	/Styles.Icon.command.en_inspired_warfare	
expertise_en_improv_1	/Styles.Icon.command.en_improv	
expertise_en_holographic_mastery_1	/Styles.Icon.command.en_holographic_mastery	
expertise_en_holographic_mastery_2	/Styles.Icon.command.en_holographic_mastery	
expertise_en_holographic_duration_1	/Styles.Icon.command.en_holographic_image	
expertise_en_dramatic_flair_1	/Styles.Icon.command.en_dramatic_flair	
expertise_en_dramatic_flair_2	/Styles.Icon.command.en_dramatic_flair	
expertise_en_dramatic_flair_3	/Styles.Icon.command.en_dramatic_flair	
expertise_en_dramatic_flair_4	/Styles.Icon.command.en_dramatic_flair	
expertise_en_strike_1	/Styles.Icon.command.en_strike	
expertise_en_conditioned_vessel_1	/Styles.Icon.command.en_conditioned_vessel	
expertise_en_conditioned_vessel_2	/Styles.Icon.command.en_conditioned_vessel	
expertise_en_conditioned_vessel_3	/Styles.Icon.command.en_conditioned_vessel	
expertise_en_conditioned_vessel_4	/Styles.Icon.command.en_conditioned_vessel	
expertise_en_thought_as_action_1	/Styles.Icon.command.en_thought_as_action	
expertise_en_thought_as_action_2	/Styles.Icon.command.en_thought_as_action	
expertise_en_thought_as_action_3	/Styles.Icon.command.en_thought_as_action	
expertise_en_thought_as_action_4	/Styles.Icon.command.en_thought_as_action	
expertise_en_folded_inward_1	/Styles.Icon.command.en_folded_inward	
expertise_en_folded_inward_2	/Styles.Icon.command.en_folded_inward	
expertise_en_folded_inward_3	/Styles.Icon.command.en_folded_inward	
expertise_en_folded_inward_4	/Styles.Icon.command.en_folded_inward	
expertise_en_thrill_1	/Styles.Icon.command.en_thrill	
expertise_en_project_will_1	/Styles.Icon.command.en_project_will	
expertise_en_rising_spirit_1	/Styles.Icon.command.en_rising_spirit	
expertise_en_rising_spirit_2	/Styles.Icon.command.en_rising_spirit	
expertise_en_rising_spirit_3	/Styles.Icon.command.en_rising_spirit	
expertise_en_rising_spirit_4	/Styles.Icon.command.en_rising_spirit	
expertise_en_focused_control_1	/Styles.Icon.command.en_focused_control	
expertise_en_focused_control_2	/Styles.Icon.command.en_focused_control	
expertise_en_focused_control_3	/Styles.Icon.command.en_focused_control	
expertise_en_focused_control_4	/Styles.Icon.command.en_focused_control	
expertise_en_heal_1	/Styles.Icon.command.en_heal	
expertise_en_heal_2	/Styles.Icon.command.en_heal	
expertise_en_heal_3	/Styles.Icon.command.en_heal	
expertise_en_heal_4	/Styles.Icon.command.en_heal	
expertise_en_encore_heal_1	/Styles.Icon.command.en_encore_heal	
expertise_en_encore_heal_2	/Styles.Icon.command.en_encore_heal	
expertise_en_encore_heal_3	/Styles.Icon.command.en_encore_heal	
expertise_en_emotional_prescience_1	/Styles.Icon.command.en_emotional_prescience	
expertise_en_emotional_prescience_2	/Styles.Icon.command.en_emotional_prescience	
expertise_en_emotional_prescience_3	/Styles.Icon.command.en_emotional_prescience	
expertise_en_emotional_prescience_4	/Styles.Icon.command.en_emotional_prescience	
expertise_en_to_the_hilt_1	/Styles.Icon.command.en_to_the_hilt	
expertise_en_to_the_hilt_2	/Styles.Icon.command.en_to_the_hilt	
expertise_en_sweeping_pirouette_1	/Styles.Icon.command.en_sweeping_pirouette	
expertise_en_controlled_spin_1	/Styles.Icon.command.en_controlled_spin	
expertise_en_controlled_spin_2	/Styles.Icon.command.en_controlled_spin	
expertise_en_controlled_spin_3	/Styles.Icon.command.en_controlled_spin	
expertise_en_void_dance_1	/Styles.Icon.command.en_void_dance	
expertise_en_show_stopper_1	/Styles.Icon.command.en_show_stopper	
expertise_en_show_stopper_2	/Styles.Icon.command.en_show_stopper	
expertise_en_show_stopper_3	/Styles.Icon.command.en_show_stopper	
expertise_en_unhealthy_fixation_1	/Styles.Icon.command.en_unhealthy_fixation	
expertise_en_allure_1	/Styles.Icon.command.en_allure	
expertise_en_allure_2	/Styles.Icon.command.en_allure	
expertise_en_allure_3	/Styles.Icon.command.en_allure	
expertise_en_allure_4	/Styles.Icon.command.en_allure	
expertise_en_spiral_kick_1	/Styles.Icon.command.en_spiral_kick	
expertise_en_uprising_1	/Styles.Icon.command.en_uprising	
expertise_en_uprising_2	/Styles.Icon.command.en_uprising	
expertise_en_annulling_1	/Styles.Icon.command.en_annulling	
expertise_en_annulling_2	/Styles.Icon.command.en_annulling	
expertise_en_annulling_3	/Styles.Icon.command.en_annulling	
expertise_en_stage_presence_1	/Styles.Icon.command.en_stage_presence	
expertise_en_stage_presence_2	/Styles.Icon.command.en_stage_presence	
expertise_en_stage_presence_3	/Styles.Icon.command.en_stage_presence	
expertise_en_sprint_1	/Styles.Icon.command.en_sprint	
class_domestics_phase1_novice	/Styles.Icon.command.trader_artisan_advanced_theory	
class_domestics_phase1_02	/Styles.Icon.command.trader_profession_1_first_schematic	
class_domestics_phase1_03	/Styles.Icon.command.trader_profession_1_second_schematic	
class_domestics_phase1_04	/Styles.Icon.command.trader_artisan_dexterity	
class_domestics_phase1_05	/Styles.Icon.command.trader_profession_2_first_schematic	
class_domestics_phase1_master	/Styles.Icon.command.trader_artisan_hypothesis	
class_domestics_phase2_novice	/Styles.Icon.command.trader_profession_2_second_schematic	
class_domestics_phase2_02	/Styles.Icon.command.trader_business_accounting	
class_domestics_phase2_03	/Styles.Icon.command.trader_factory_energy	
class_domestics_phase2_04	/Styles.Icon.command.trader_factory_maintenance	
class_domestics_phase2_05	/Styles.Icon.command.trader_factory_production	
class_domestics_phase2_master	/Styles.Icon.command.trader_harvester_collection	
class_domestics_phase3_novice	/Styles.Icon.command.trader_harvester_energy	
class_domestics_phase3_02	/Styles.Icon.command.trader_harvester_maintenance	
class_domestics_phase3_03	/Styles.Icon.command.trader_harvester_storage	
class_domestics_phase3_04	/Styles.Icon.command.trader_personnel_management	
class_domestics_phase3_05	/Styles.Icon.command.trader_profession_1_advanced_theory	
class_domestics_phase3_master	/Styles.Icon.command.trader_profession_1_attachment_bonus	
class_domestics_phase4_novice	/Styles.Icon.command.trader_profession_1_dexterity	
class_domestics_phase4_02	/Styles.Icon.command.trader_resource_processing	
class_domestics_phase4_03	/Styles.Icon.command.trader_resource_refinement	
class_domestics_phase4_04	/Styles.Icon.command.trader_reverse_engineering	
class_domestics_phase4_05	/Styles.Icon.command.trader_sampling_collection	
class_domestics_phase4_master	/Styles.Icon.command.trader_warehousing	
class_structures_phase1_novice	/Styles.Icon.command.trader_artisan_advanced_theory	
class_structures_phase1_02	/Styles.Icon.command.trader_profession_1_first_schematic	
class_structures_phase1_03	/Styles.Icon.command.trader_profession_1_second_schematic	
class_structures_phase1_04	/Styles.Icon.command.trader_artisan_dexterity	
class_structures_phase1_05	/Styles.Icon.command.trader_profession_2_first_schematic	
class_structures_phase1_master	/Styles.Icon.command.trader_artisan_hypothesis	
class_structures_phase2_novice	/Styles.Icon.command.trader_profession_2_second_schematic	
class_structures_phase2_02	/Styles.Icon.command.trader_business_accounting	
class_structures_phase2_03	/Styles.Icon.command.trader_factory_energy	
class_structures_phase2_04	/Styles.Icon.command.trader_factory_maintenance	
class_structures_phase2_05	/Styles.Icon.command.trader_factory_production	
class_structures_phase2_master	/Styles.Icon.command.trader_harvester_collection	
class_structures_phase3_novice	/Styles.Icon.command.trader_harvester_energy	
class_structures_phase3_02	/Styles.Icon.command.trader_harvester_maintenance	
class_structures_phase3_03	/Styles.Icon.command.trader_harvester_storage	
class_structures_phase3_04	/Styles.Icon.command.trader_personnel_management	
class_structures_phase3_05	/Styles.Icon.command.trader_profession_1_advanced_theory	
class_structures_phase3_master	/Styles.Icon.command.trader_profession_1_attachment_bonus	
class_structures_phase4_novice	/Styles.Icon.command.trader_profession_1_dexterity	
class_structures_phase4_02	/Styles.Icon.command.trader_resource_processing	
class_structures_phase4_03	/Styles.Icon.command.trader_resource_refinement	
class_structures_phase4_04	/Styles.Icon.command.trader_reverse_engineering	
class_structures_phase4_05	/Styles.Icon.command.trader_sampling_collection	
class_structures_phase4_master	/Styles.Icon.command.trader_warehousing	
class_munitions_phase1_novice	/Styles.Icon.command.trader_artisan_advanced_theory	
class_munitions_phase1_02	/Styles.Icon.command.trader_profession_1_first_schematic	
class_munitions_phase1_03	/Styles.Icon.command.trader_profession_1_second_schematic	
class_munitions_phase1_04	/Styles.Icon.command.trader_artisan_dexterity	
class_munitions_phase1_05	/Styles.Icon.command.trader_profession_2_first_schematic	
class_munitions_phase1_master	/Styles.Icon.command.trader_artisan_hypothesis	
class_munitions_phase2_novice	/Styles.Icon.command.trader_profession_2_second_schematic	
class_munitions_phase2_02	/Styles.Icon.command.trader_business_accounting	
class_munitions_phase2_03	/Styles.Icon.command.trader_factory_energy	
class_munitions_phase2_04	/Styles.Icon.command.trader_factory_maintenance	
class_munitions_phase2_05	/Styles.Icon.command.trader_factory_production	
class_munitions_phase2_master	/Styles.Icon.command.trader_harvester_collection	
class_munitions_phase3_novice	/Styles.Icon.command.trader_harvester_energy	
class_munitions_phase3_02	/Styles.Icon.command.trader_harvester_maintenance	
class_munitions_phase3_03	/Styles.Icon.command.trader_harvester_storage	
class_munitions_phase3_04	/Styles.Icon.command.trader_personnel_management	
class_munitions_phase3_05	/Styles.Icon.command.trader_profession_1_advanced_theory	
class_munitions_phase3_master	/Styles.Icon.command.trader_profession_1_attachment_bonus	
class_munitions_phase4_novice	/Styles.Icon.command.trader_profession_1_dexterity	
class_munitions_phase4_02	/Styles.Icon.command.trader_resource_processing	
class_munitions_phase4_03	/Styles.Icon.command.trader_resource_refinement	
class_munitions_phase4_04	/Styles.Icon.command.trader_reverse_engineering	
class_munitions_phase4_05	/Styles.Icon.command.trader_sampling_collection	
class_munitions_phase4_master	/Styles.Icon.command.trader_warehousing	
class_engineering_phase1_novice	/Styles.Icon.command.trader_artisan_advanced_theory	
class_engineering_phase1_02	/Styles.Icon.command.trader_profession_1_first_schematic	
class_engineering_phase1_03	/Styles.Icon.command.trader_profession_1_second_schematic	
class_engineering_phase1_04	/Styles.Icon.command.trader_artisan_dexterity	
class_engineering_phase1_05	/Styles.Icon.command.trader_profession_2_first_schematic	
class_engineering_phase1_master	/Styles.Icon.command.trader_artisan_hypothesis	
class_engineering_phase2_novice	/Styles.Icon.command.trader_profession_2_second_schematic	
class_engineering_phase2_02	/Styles.Icon.command.trader_business_accounting	
class_engineering_phase2_03	/Styles.Icon.command.trader_factory_energy	
class_engineering_phase2_04	/Styles.Icon.command.trader_factory_maintenance	
class_engineering_phase2_05	/Styles.Icon.command.trader_factory_production	
class_engineering_phase2_master	/Styles.Icon.command.trader_harvester_collection	
class_engineering_phase3_novice	/Styles.Icon.command.trader_harvester_energy	
class_engineering_phase3_02	/Styles.Icon.command.trader_harvester_maintenance	
class_engineering_phase3_03	/Styles.Icon.command.trader_harvester_storage	
class_engineering_phase3_04	/Styles.Icon.command.trader_personnel_management	
class_engineering_phase3_05	/Styles.Icon.command.trader_profession_1_advanced_theory	
class_engineering_phase3_master	/Styles.Icon.command.trader_profession_1_attachment_bonus	
class_engineering_phase4_novice	/Styles.Icon.command.trader_profession_1_dexterity	
class_engineering_phase4_02	/Styles.Icon.command.trader_resource_processing	
class_engineering_phase4_03	/Styles.Icon.command.trader_resource_refinement	
class_engineering_phase4_04	/Styles.Icon.command.trader_reverse_engineering	
class_engineering_phase4_05	/Styles.Icon.command.trader_sampling_collection	
class_engineering_phase4_master	/Styles.Icon.command.trader_warehousing	
expertise_bm_incubation_base_1	/Styles.Icon.command.bm_incubation	
expertise_bm_incubation_mod_1	/Styles.Icon.command.bm_incubation_mod	
expertise_bm_incubation_mod_2	/Styles.Icon.command.bm_incubation_mod	
expertise_bm_incubation_mod_3	/Styles.Icon.command.bm_incubation_mod	
expertise_bm_incubation_mod_4	/Styles.Icon.command.bm_incubation_mod	
expertise_bm_abilility_aquisition_mod_1	/Styles.Icon.command.bm_abil_aquisition	
expertise_bm_abilility_aquisition_mod_2	/Styles.Icon.command.bm_abil_aquisition	
expertise_bm_abilility_aquisition_mod_3	/Styles.Icon.command.bm_abil_aquisition	
expertise_bm_abilility_aquisition_mod_4	/Styles.Icon.command.bm_abil_aquisition	
expertise_bm_pet_tricks_1	/Styles.Icon.command.bm_pet_trick	
expertise_bm_loyalty_mod_1	/Styles.Icon.command.bm_trust	
expertise_bm_loyalty_mod_2	/Styles.Icon.command.bm_trust	
expertise_bm_loyalty_mod_3	/Styles.Icon.command.bm_trust	
expertise_bm_train_mount_1	/Styles.Icon.command.bm_train_mount	
expertise_bm_add_first_pet_bar_1	/Styles.Icon.command.bm_add_pet_bar	
expertise_bm_attack_1	/Styles.Icon.command.bm_pet_attack	
expertise_bm_metagame_mod_1	/Styles.Icon.command.bm_generic_icon	
expertise_bm_metagame_mod_2	/Styles.Icon.command.bm_generic_icon	
expertise_bm_metagame_mod_3	/Styles.Icon.command.bm_generic_icon	
expertise_bm_swiftness_1	/Styles.Icon.command.bm_swiftness	
expertise_bm_add_second_pet_bar_1	/Styles.Icon.command.bm_add_pet_bar	
expertise_bm_swift_recovery_1	/Styles.Icon.command.bm_pet_recovery	
expertise_bm_mending_1	/Styles.Icon.command.bm_mend_pet	
expertise_bm_soothing_comfort_1	/Styles.Icon.command.bm_soothing_comfort	
expertise_bm_specialized_supplements_1	/Styles.Icon.command.bm_supplements	
expertise_bm_pet_recovery_1	/Styles.Icon.command.bm_revive_pet	
expertise_bm_add_third_pet_bar_1	/Styles.Icon.command.bm_add_pet_bar	
expertise_bm_mutual_trust_1	/Styles.Icon.command.bm_trust	
expertise_bm_mutual_trust_2	/Styles.Icon.command.bm_trust	
expertise_bm_mutual_trust_3	/Styles.Icon.command.bm_trust	
expertise_bm_exceptional_nutrition_1	/Styles.Icon.command.bm_nutrition	
expertise_bm_exceptional_nutrition_2	/Styles.Icon.command.bm_nutrition	
expertise_bm_exceptional_nutrition_3	/Styles.Icon.command.bm_nutrition	
expertise_bm_dexterity_training_1	/Styles.Icon.command.bm_swiftness	
expertise_bm_dexterity_training_2	/Styles.Icon.command.bm_swiftness	
expertise_bm_dexterity_training_3	/Styles.Icon.command.bm_swiftness	
expertise_bm_fortitude_1	/Styles.Icon.command.bm_fortitude	
expertise_bm_fortitude_2	/Styles.Icon.command.bm_fortitude	
expertise_bm_fortitude_3	/Styles.Icon.command.bm_fortitude	
expertise_bm_savagery_1	/Styles.Icon.command.bm_savagery	
expertise_bm_savagery_2	/Styles.Icon.command.bm_savagery	
expertise_bm_savagery_3	/Styles.Icon.command.bm_savagery	
expertise_bm_beast_mastery_1	/Styles.Icon.command.bm_beast_mastery	
expertise_bm_beast_mastery_2	/Styles.Icon.command.bm_beast_mastery	
expertise_bm_beast_mastery_3	/Styles.Icon.command.bm_beast_mastery	
expertise_bm_creature_knowledge_command_1	/Styles.Icon.command.bm_creature_knowledge_command	
expertise_bm_genetic_engineering_1	/Styles.Icon.command.trader_profession_2_keen_understanding	
expertise_bm_genetic_engineering_2	/Styles.Icon.command.trader_profession_2_keen_understanding	
expertise_bm_genetic_engineering_3	/Styles.Icon.command.trader_profession_2_keen_understanding	
expertise_bm_genetic_engineering_4	/Styles.Icon.command.trader_profession_2_keen_understanding	
expertise_bm_dna_harvesting_1	/Styles.Icon.command.bm_collect_dna	
expertise_bm_dna_harvesting_2	/Styles.Icon.command.bm_collect_dna	
expertise_bm_dna_harvesting_3	/Styles.Icon.command.bm_collect_dna	
expertise_bm_evasion_1	/Styles.Icon.command.bm_evasion	
expertise_bm_evasion_2	/Styles.Icon.command.bm_evasion	
expertise_bm_evasion_3	/Styles.Icon.command.bm_evasion	
expertise_bm_pet_dodge_1	/Styles.Icon.command.bm_pet_dodge	
expertise_bm_pet_dodge_2	/Styles.Icon.command.bm_pet_dodge	
expertise_bm_pet_dodge_3	/Styles.Icon.command.bm_pet_dodge	
expertise_bm_erratic_genius_1	/Styles.Icon.command.bm_erratic_genius	
expertise_bm_erratic_genius_2	/Styles.Icon.command.bm_erratic_genius	
expertise_bm_erratic_genius_3	/Styles.Icon.command.bm_erratic_genius	
expertise_bm_improved_healing_1	/Styles.Icon.command.bm_improved_healing	
expertise_bm_improved_healing_2	/Styles.Icon.command.bm_improved_healing	
expertise_bm_improved_healing_3	/Styles.Icon.command.bm_improved_healing	
expertise_of_dm_1	/Styles.Icon.command.of_pistol_dm	
expertise_of_pistol_bleed	/Styles.Icon.command.of_pistol_bleed	
class_chronicles_novice	/Styles.Icon.chronicles.class_chronicles_novice	
class_chronicles_1	/Styles.Icon.chronicles.class_chronicles_1	
class_chronicles_2	/Styles.Icon.chronicles.class_chronicles_2	
class_chronicles_3	/Styles.Icon.chronicles.class_chronicles_3	
class_chronicles_4	/Styles.Icon.chronicles.class_chronicles_4	
class_chronicles_5	/Styles.Icon.chronicles.class_chronicles_5	
class_chronicles_6	/Styles.Icon.chronicles.class_chronicles_6	
class_chronicles_7	/Styles.Icon.chronicles.class_chronicles_7	
class_chronicles_8	/Styles.Icon.chronicles.class_chronicles_8	
class_chronicles_9	/Styles.Icon.chronicles.class_chronicles_9	
class_chronicles_10	/Styles.Icon.chronicles.class_chronicles_10	
class_chronicles_11	/Styles.Icon.chronicles.class_chronicles_11	
class_chronicles_12	/Styles.Icon.chronicles.class_chronicles_12	
class_chronicles_13	/Styles.Icon.chronicles.class_chronicles_13	
class_chronicles_14	/Styles.Icon.chronicles.class_chronicles_14	
class_chronicles_15	/Styles.Icon.chronicles.class_chronicles_15	
class_chronicles_16	/Styles.Icon.chronicles.class_chronicles_16	
class_chronicles_master	/Styles.Icon.chronicles.class_chronicles_master	
